States/UTs,Crimes,Year,Persons_arrested_male,Persons_arrested_female,Persons_arrested_total
Andhra Pradesh,Murder (Section 302 IPC),2014,2111,223,2334
Andhra Pradesh,Attempt to commit Murder (Section 307 IPC),2014,2578,97,2675
Andhra Pradesh,Culpable Homicide not amounting to Murder (Section 304 IPC),2014,94,7,101
Andhra Pradesh,Attempt to commit Culpable Homicide (Section 308 IPC),2014,4,0,4
Andhra Pradesh,Rape (Section 376 IPC),2014,1191,46,1237
Andhra Pradesh,Custodial Rape,2014,0,0,0
Andhra Pradesh,Gang Rape,2014,0,0,0
Andhra Pradesh,Other Rape,2014,0,0,0
Andhra Pradesh,Rape other than Custodial,2014,1191,46,1237
Andhra Pradesh,Gang Rape,2014,24,0,24
Andhra Pradesh,Other Rape,2014,1167,46,1213
Andhra Pradesh,Attempt to commit Rape (Section 376/511 IPC),2014,173,0,173
Andhra Pradesh,"Kidnapping & Abduction_Total (Section 3,364,364A, 366-369 IPC)",2014,1419,79,1498
Andhra Pradesh,Kidnapping & Abduction (Section 363 IPC),2014,415,29,444
Andhra Pradesh,Kidnaping & Abduction in order to Murder (Section 364 IPC),2014,9,0,9
Andhra Pradesh,Kidnapping for Ransom (Section 364A IPC),2014,13,0,13
Andhra Pradesh,Kidnapping & Abduction of Women to compel her for marriage (Section 366 IPC),2014,436,19,455
Andhra Pradesh,Other Kidnapping,2014,546,31,577
Andhra Pradesh,"Dacoity (Section 395,396-398 IPC)",2014,325,1,326
Andhra Pradesh,Dacoity with Murder (Section 396 IPC),2014,6,0,6
Andhra Pradesh,Other Dacoity,2014,319,1,320
Andhra Pradesh,Making Preparation and Assembly for committing Dacoity (Section 399 & 402 IPC),2014,8,0,8
Andhra Pradesh,"Robbery (Section 392 to 394, 397 and 398 IPC)",2014,631,10,641
Andhra Pradesh,Criminal Trespass/Burglary_Total (Section 453 to 460 IPC),2014,5409,70,5479
Andhra Pradesh,"Criminal Trespass/Burglary (Section 455, 457 & 458 IPC)",2014,4009,46,4055
Andhra Pradesh,"House Trespass & House Breaking (Section 453,454,456,459 & 460 IPC)",2014,1400,24,1424
Andhra Pradesh,Theft (Section 379 to 382 IPC),2014,13438,348,13786
Andhra Pradesh,Auto Theft,2014,3697,39,3736
Andhra Pradesh,Other Thefts,2014,9741,309,10050
Andhra Pradesh,"Unlawful Assembly (Section 143,144 & 145)",2014,272,16,288
Andhra Pradesh,"Riots (Section 147, 148, 149, 150 & 151 IPC)",2014,6596,275,6871
Andhra Pradesh,Communal,2014,181,5,186
Andhra Pradesh,Industrial,2014,31,0,31
Andhra Pradesh,Political,2014,1950,40,1990
Andhra Pradesh,Caste Conflict,2014,55,0,55
Andhra Pradesh,SC/STs Vs. Non-SCs/STs,2014,55,0,55
Andhra Pradesh,Other Caste Riots,2014,0,0,0
Andhra Pradesh,Agrarian,2014,0,0,0
Andhra Pradesh,Students,2014,0,0,0
Andhra Pradesh,Sectarian,2014,0,0,0
Andhra Pradesh,Other Riots,2014,4379,230,4609
Andhra Pradesh,Criminal Breach of Trust (Section 406 to 409 IPC),2014,1117,51,1168
Andhra Pradesh,Cheating (Section 420 IPC),2014,6725,304,7029
Andhra Pradesh,"Forgery (Section 465, 468 & 471 IPC)",2014,188,11,199
Andhra Pradesh,"Counterfeiting (Section 231-235,237-240, 242-243, 255 and 489-A to 489-E IPC)",2014,146,0,146
Andhra Pradesh,"Offences related to Counterfeit Coin (Section 231-235,237, 238-240 & 242-243 IPC)",2014,6,0,6
Andhra Pradesh,Counterfeiting Government Stamp (Section 255 IPC),2014,0,0,0
Andhra Pradesh,Counterfeit currency & Bank notes (Section 489-A to 489-E IPC),2014,140,0,140
Andhra Pradesh,Counterfeiting currency notes or Bank notes (Section 489A IPC),2014,69,0,69
Andhra Pradesh,Using forged or counterfeit currency/Bank notes (Section 489B IPC),2014,32,0,32
Andhra Pradesh,Possession of forged or counterfeiting currency / Bank notes (Section 489C IPC),2014,37,0,37
Andhra Pradesh,Make/Possess materials for forging or counterfeiting currency/Bank notes (Section 489D IPC),2014,2,0,2
Andhra Pradesh,Make/Use documents resembling currency notes/Bank notes (Section 489 E IPC),2014,0,0,0
Andhra Pradesh,Arson (Section 435-436 & 438 IPC),2014,484,17,501
Andhra Pradesh,"Grievous Hurt (Section 325,326,326A & 326 B IPC)",2014,1112,139,1251
Andhra Pradesh,Grievous Hurt (Section 325 & 326 IPC),2014,1101,139,1240
Andhra Pradesh,Acid attack (Section 326A IPC),2014,7,0,7
Andhra Pradesh,Attempt to Acid Attack (Section 326B IPC),2014,4,0,4
Andhra Pradesh,Dowry Deaths (Section 304-B IPC),2014,395,136,531
Andhra Pradesh,Assault on women with intent to outrage her Modesty (Section 354 IPC),2014,4759,156,4915
Andhra Pradesh,Sexual Harassment (Section 354A IPC),2014,1043,20,1063
Andhra Pradesh,Assault on women with intent to Disrobe (Section 354B IPC),2014,371,7,378
Andhra Pradesh,Voyeurism (Section 354C IPC),2014,86,0,86
Andhra Pradesh,Stalking (Section 354D IPC),2014,513,4,517
Andhra Pradesh,Others,2014,2746,125,2871
Andhra Pradesh,Insult to the Modesty of Women (Section 509 IPC),2014,2930,90,3020
Andhra Pradesh,At Office premises,2014,2,0,2
Andhra Pradesh,Places related to work other than Office,2014,107,0,107
Andhra Pradesh,In Public Transport system,2014,68,0,68
Andhra Pradesh,In Other Places,2014,2753,90,2843
Andhra Pradesh,Cruelty by Husband or his Relatives (Section 498-A IPC),2014,7770,1500,9270
Andhra Pradesh,Importation of Girls from Foreign Country (Section 366-B IPC),2014,0,0,0
Andhra Pradesh,Causing Death by Negligence (Section 304-A IPC),2014,6742,17,6759
Andhra Pradesh,Deaths due to negligent driving/act,2014,6620,10,6630
Andhra Pradesh,Deaths due to Other Causes,2014,122,7,129
Andhra Pradesh,"Offences against State (Section 121, 121A, 122, 123, 124-A IPC)",2014,0,0,0
Andhra Pradesh,Sedition (Section 124A IPC),2014,0,0,0
Andhra Pradesh,Other offences against State,2014,0,0,0
Andhra Pradesh,Offences promoting enmity between different groups (Section 153A & 153B IPC),2014,42,0,42
Andhra Pradesh,Promoting enmity on ground of religion race and place of Birth (Section 153A IPC),2014,42,0,42
Andhra Pradesh,Imputation & assertions prejudicial to national integration (Section 153B IPC),2014,0,0,0
Andhra Pradesh,Extortion (Section 384 - 389 IPC),2014,324,4,328
Andhra Pradesh,Disclosure of Identity of Victims (Section 228 A IPC),2014,0,0,0
Andhra Pradesh,Incidence of Rash Driving (Section 279 IPC Read with 337 & 338),2014,13421,77,13498
Andhra Pradesh,Human Trafficking (Section 370 & 370A IPC),2014,7,3,10
Andhra Pradesh,Unnatural Offences U/s 377 IPC,2014,1,0,1
Andhra Pradesh,Other IPC crimes,2014,74894,7228,82122
Andhra Pradesh,Total Cognizable IPC crimes,2014,155306,10905,166211
Arunachal Pradesh,Murder (Section 302 IPC),2014,177,5,182
Arunachal Pradesh,Attempt to commit Murder (Section 307 IPC),2014,69,1,70
Arunachal Pradesh,Culpable Homicide not amounting to Murder (Section 304 IPC),2014,3,0,3
Arunachal Pradesh,Attempt to commit Culpable Homicide (Section 308 IPC),2014,0,0,0
Arunachal Pradesh,Rape (Section 376 IPC),2014,91,2,93
Arunachal Pradesh,Custodial Rape,2014,4,0,4
Arunachal Pradesh,Gang Rape,2014,0,0,0
Arunachal Pradesh,Other Rape,2014,4,0,4
Arunachal Pradesh,Rape other than Custodial,2014,87,2,89
Arunachal Pradesh,Gang Rape,2014,10,0,10
Arunachal Pradesh,Other Rape,2014,77,2,79
Arunachal Pradesh,Attempt to commit Rape (Section 376/511 IPC),2014,12,1,13
Arunachal Pradesh,"Kidnapping & Abduction_Total (Section 3,364,364A, 366-369 IPC)",2014,141,20,161
Arunachal Pradesh,Kidnapping & Abduction (Section 363 IPC),2014,25,2,27
Arunachal Pradesh,Kidnaping & Abduction in order to Murder (Section 364 IPC),2014,1,1,2
Arunachal Pradesh,Kidnapping for Ransom (Section 364A IPC),2014,9,0,9
Arunachal Pradesh,Kidnapping & Abduction of Women to compel her for marriage (Section 366 IPC),2014,15,5,20
Arunachal Pradesh,Other Kidnapping,2014,91,12,103
Arunachal Pradesh,"Dacoity (Section 395,396-398 IPC)",2014,15,0,15
Arunachal Pradesh,Dacoity with Murder (Section 396 IPC),2014,0,0,0
Arunachal Pradesh,Other Dacoity,2014,15,0,15
Arunachal Pradesh,Making Preparation and Assembly for committing Dacoity (Section 399 & 402 IPC),2014,0,0,0
Arunachal Pradesh,"Robbery (Section 392 to 394, 397 and 398 IPC)",2014,96,1,97
Arunachal Pradesh,Criminal Trespass/Burglary_Total (Section 453 to 460 IPC),2014,120,0,120
Arunachal Pradesh,"Criminal Trespass/Burglary (Section 455, 457 & 458 IPC)",2014,103,0,103
Arunachal Pradesh,"House Trespass & House Breaking (Section 453,454,456,459 & 460 IPC)",2014,17,0,17
Arunachal Pradesh,Theft (Section 379 to 382 IPC),2014,335,9,344
Arunachal Pradesh,Auto Theft,2014,71,0,71
Arunachal Pradesh,Other Thefts,2014,264,9,273
Arunachal Pradesh,"Unlawful Assembly (Section 143,144 & 145)",2014,20,1,21
Arunachal Pradesh,"Riots (Section 147, 148, 149, 150 & 151 IPC)",2014,130,8,138
Arunachal Pradesh,Communal,2014,15,0,15
Arunachal Pradesh,Industrial,2014,0,0,0
Arunachal Pradesh,Political,2014,37,8,45
Arunachal Pradesh,Caste Conflict,2014,0,0,0
Arunachal Pradesh,SC/STs Vs. Non-SCs/STs,2014,0,0,0
Arunachal Pradesh,Other Caste Riots,2014,0,0,0
Arunachal Pradesh,Agrarian,2014,0,0,0
Arunachal Pradesh,Students,2014,5,0,5
Arunachal Pradesh,Sectarian,2014,0,0,0
Arunachal Pradesh,Other Riots,2014,73,0,73
Arunachal Pradesh,Criminal Breach of Trust (Section 406 to 409 IPC),2014,28,2,30
Arunachal Pradesh,Cheating (Section 420 IPC),2014,73,14,87
Arunachal Pradesh,"Forgery (Section 465, 468 & 471 IPC)",2014,9,1,10
Arunachal Pradesh,"Counterfeiting (Section 231-235,237-240, 242-243, 255 and 489-A to 489-E IPC)",2014,0,0,0
Arunachal Pradesh,"Offences related to Counterfeit Coin (Section 231-235,237, 238-240 & 242-243 IPC)",2014,0,0,0
Arunachal Pradesh,Counterfeiting Government Stamp (Section 255 IPC),2014,0,0,0
Arunachal Pradesh,Counterfeit currency & Bank notes (Section 489-A to 489-E IPC),2014,0,0,0
Arunachal Pradesh,Counterfeiting currency notes or Bank notes (Section 489A IPC),2014,0,0,0
Arunachal Pradesh,Using forged or counterfeit currency/Bank notes (Section 489B IPC),2014,0,0,0
Arunachal Pradesh,Possession of forged or counterfeiting currency / Bank notes (Section 489C IPC),2014,0,0,0
Arunachal Pradesh,Make/Possess materials for forging or counterfeiting currency/Bank notes (Section 489D IPC),2014,0,0,0
Arunachal Pradesh,Make/Use documents resembling currency notes/Bank notes (Section 489 E IPC),2014,0,0,0
Arunachal Pradesh,Arson (Section 435-436 & 438 IPC),2014,23,0,23
Arunachal Pradesh,"Grievous Hurt (Section 325,326,326A & 326 B IPC)",2014,304,10,314
Arunachal Pradesh,Grievous Hurt (Section 325 & 326 IPC),2014,304,10,314
Arunachal Pradesh,Acid attack (Section 326A IPC),2014,0,0,0
Arunachal Pradesh,Attempt to Acid Attack (Section 326B IPC),2014,0,0,0
Arunachal Pradesh,Dowry Deaths (Section 304-B IPC),2014,1,0,1
Arunachal Pradesh,Assault on women with intent to outrage her Modesty (Section 354 IPC),2014,151,13,164
Arunachal Pradesh,Sexual Harassment (Section 354A IPC),2014,27,0,27
Arunachal Pradesh,Assault on women with intent to Disrobe (Section 354B IPC),2014,0,0,0
Arunachal Pradesh,Voyeurism (Section 354C IPC),2014,6,0,6
Arunachal Pradesh,Stalking (Section 354D IPC),2014,1,0,1
Arunachal Pradesh,Others,2014,117,13,130
Arunachal Pradesh,Insult to the Modesty of Women (Section 509 IPC),2014,3,0,3
Arunachal Pradesh,At Office premises,2014,0,0,0
Arunachal Pradesh,Places related to work other than Office,2014,0,0,0
Arunachal Pradesh,In Public Transport system,2014,0,0,0
Arunachal Pradesh,In Other Places,2014,3,0,3
Arunachal Pradesh,Cruelty by Husband or his Relatives (Section 498-A IPC),2014,40,4,44
Arunachal Pradesh,Importation of Girls from Foreign Country (Section 366-B IPC),2014,0,0,0
Arunachal Pradesh,Causing Death by Negligence (Section 304-A IPC),2014,37,0,37
Arunachal Pradesh,Deaths due to negligent driving/act,2014,35,0,35
Arunachal Pradesh,Deaths due to Other Causes,2014,2,0,2
Arunachal Pradesh,"Offences against State (Section 121, 121A, 122, 123, 124-A IPC)",2014,0,0,0
Arunachal Pradesh,Sedition (Section 124A IPC),2014,0,0,0
Arunachal Pradesh,Other offences against State,2014,0,0,0
Arunachal Pradesh,Offences promoting enmity between different groups (Section 153A & 153B IPC),2014,0,0,0
Arunachal Pradesh,Promoting enmity on ground of religion race and place of Birth (Section 153A IPC),2014,0,0,0
Arunachal Pradesh,Imputation & assertions prejudicial to national integration (Section 153B IPC),2014,0,0,0
Arunachal Pradesh,Extortion (Section 384 - 389 IPC),2014,159,1,160
Arunachal Pradesh,Disclosure of Identity of Victims (Section 228 A IPC),2014,0,0,0
Arunachal Pradesh,Incidence of Rash Driving (Section 279 IPC Read with 337 & 338),2014,72,0,72
Arunachal Pradesh,Human Trafficking (Section 370 & 370A IPC),2014,0,0,0
Arunachal Pradesh,Unnatural Offences U/s 377 IPC,2014,0,0,0
Arunachal Pradesh,Other IPC crimes,2014,932,28,960
Arunachal Pradesh,Total Cognizable IPC crimes,2014,3041,121,3162
Assam,Murder (Section 302 IPC),2014,3609,20,3629
Assam,Attempt to commit Murder (Section 307 IPC),2014,1738,6,1744
Assam,Culpable Homicide not amounting to Murder (Section 304 IPC),2014,151,0,151
Assam,Attempt to commit Culpable Homicide (Section 308 IPC),2014,14,0,14
Assam,Rape (Section 376 IPC),2014,3673,0,3673
Assam,Custodial Rape,2014,0,0,0
Assam,Gang Rape,2014,0,0,0
Assam,Other Rape,2014,0,0,0
Assam,Rape other than Custodial,2014,3673,0,3673
Assam,Gang Rape,2014,46,0,46
Assam,Other Rape,2014,3627,0,3627
Assam,Attempt to commit Rape (Section 376/511 IPC),2014,227,0,227
Assam,"Kidnapping & Abduction_Total (Section 3,364,364A, 366-369 IPC)",2014,7926,10,7936
Assam,Kidnapping & Abduction (Section 363 IPC),2014,0,0,0
Assam,Kidnaping & Abduction in order to Murder (Section 364 IPC),2014,6,0,6
Assam,Kidnapping for Ransom (Section 364A IPC),2014,49,0,49
Assam,Kidnapping & Abduction of Women to compel her for marriage (Section 366 IPC),2014,6583,0,6583
Assam,Other Kidnapping,2014,1288,10,1298
Assam,"Dacoity (Section 395,396-398 IPC)",2014,666,0,666
Assam,Dacoity with Murder (Section 396 IPC),2014,1,0,1
Assam,Other Dacoity,2014,665,0,665
Assam,Making Preparation and Assembly for committing Dacoity (Section 399 & 402 IPC),2014,30,0,30
Assam,"Robbery (Section 392 to 394, 397 and 398 IPC)",2014,2181,0,2181
Assam,Criminal Trespass/Burglary_Total (Section 453 to 460 IPC),2014,6455,0,6455
Assam,"Criminal Trespass/Burglary (Section 455, 457 & 458 IPC)",2014,5688,0,5688
Assam,"House Trespass & House Breaking (Section 453,454,456,459 & 460 IPC)",2014,767,0,767
Assam,Theft (Section 379 to 382 IPC),2014,19120,47,19167
Assam,Auto Theft,2014,5200,0,5200
Assam,Other Thefts,2014,13920,47,13967
Assam,"Unlawful Assembly (Section 143,144 & 145)",2014,1308,0,1308
Assam,"Riots (Section 147, 148, 149, 150 & 151 IPC)",2014,5624,46,5670
Assam,Communal,2014,0,0,0
Assam,Industrial,2014,0,0,0
Assam,Political,2014,3,0,3
Assam,Caste Conflict,2014,0,0,0
Assam,SC/STs Vs. Non-SCs/STs,2014,0,0,0
Assam,Other Caste Riots,2014,0,0,0
Assam,Agrarian,2014,0,0,0
Assam,Students,2014,0,0,0
Assam,Sectarian,2014,0,0,0
Assam,Other Riots,2014,5621,46,5667
Assam,Criminal Breach of Trust (Section 406 to 409 IPC),2014,3323,2,3325
Assam,Cheating (Section 420 IPC),2014,4214,4,4218
Assam,"Forgery (Section 465, 468 & 471 IPC)",2014,90,0,90
Assam,"Counterfeiting (Section 231-235,237-240, 242-243, 255 and 489-A to 489-E IPC)",2014,153,0,153
Assam,"Offences related to Counterfeit Coin (Section 231-235,237, 238-240 & 242-243 IPC)",2014,0,0,0
Assam,Counterfeiting Government Stamp (Section 255 IPC),2014,0,0,0
Assam,Counterfeit currency & Bank notes (Section 489-A to 489-E IPC),2014,153,0,153
Assam,Counterfeiting currency notes or Bank notes (Section 489A IPC),2014,153,0,153
Assam,Using forged or counterfeit currency/Bank notes (Section 489B IPC),2014,0,0,0
Assam,Possession of forged or counterfeiting currency / Bank notes (Section 489C IPC),2014,0,0,0
Assam,Make/Possess materials for forging or counterfeiting currency/Bank notes (Section 489D IPC),2014,0,0,0
Assam,Make/Use documents resembling currency notes/Bank notes (Section 489 E IPC),2014,0,0,0
Assam,Arson (Section 435-436 & 438 IPC),2014,3103,0,3103
Assam,"Grievous Hurt (Section 325,326,326A & 326 B IPC)",2014,11485,54,11539
Assam,Grievous Hurt (Section 325 & 326 IPC),2014,11485,54,11539
Assam,Acid attack (Section 326A IPC),2014,0,0,0
Assam,Attempt to Acid Attack (Section 326B IPC),2014,0,0,0
Assam,Dowry Deaths (Section 304-B IPC),2014,284,0,284
Assam,Assault on women with intent to outrage her Modesty (Section 354 IPC),2014,3775,0,3775
Assam,Sexual Harassment (Section 354A IPC),2014,458,0,458
Assam,Assault on women with intent to Disrobe (Section 354B IPC),2014,616,0,616
Assam,Voyeurism (Section 354C IPC),2014,0,0,0
Assam,Stalking (Section 354D IPC),2014,0,0,0
Assam,Others,2014,2701,0,2701
Assam,Insult to the Modesty of Women (Section 509 IPC),2014,1,0,1
Assam,At Office premises,2014,0,0,0
Assam,Places related to work other than Office,2014,1,0,1
Assam,In Public Transport system,2014,0,0,0
Assam,In Other Places,2014,0,0,0
Assam,Cruelty by Husband or his Relatives (Section 498-A IPC),2014,12946,14,12960
Assam,Importation of Girls from Foreign Country (Section 366-B IPC),2014,1,0,1
Assam,Causing Death by Negligence (Section 304-A IPC),2014,3418,0,3418
Assam,Deaths due to negligent driving/act,2014,841,0,841
Assam,Deaths due to Other Causes,2014,2577,0,2577
Assam,"Offences against State (Section 121, 121A, 122, 123, 124-A IPC)",2014,57,0,57
Assam,Sedition (Section 124A IPC),2014,1,0,1
Assam,Other offences against State,2014,56,0,56
Assam,Offences promoting enmity between different groups (Section 153A & 153B IPC),2014,0,0,0
Assam,Promoting enmity on ground of religion race and place of Birth (Section 153A IPC),2014,0,0,0
Assam,Imputation & assertions prejudicial to national integration (Section 153B IPC),2014,0,0,0
Assam,Extortion (Section 384 - 389 IPC),2014,1242,0,1242
Assam,Disclosure of Identity of Victims (Section 228 A IPC),2014,0,0,0
Assam,Incidence of Rash Driving (Section 279 IPC Read with 337 & 338),2014,3209,0,3209
Assam,Human Trafficking (Section 370 & 370A IPC),2014,68,0,68
Assam,Unnatural Offences U/s 377 IPC,2014,0,0,0
Assam,Other IPC crimes,2014,46873,101,46974
Assam,Total Cognizable IPC crimes,2014,146964,304,147268
Bihar,Murder (Section 302 IPC),2014,5333,129,5462
Bihar,Attempt to commit Murder (Section 307 IPC),2014,5629,320,5949
Bihar,Culpable Homicide not amounting to Murder (Section 304 IPC),2014,298,0,298
Bihar,Attempt to commit Culpable Homicide (Section 308 IPC),2014,782,51,833
Bihar,Rape (Section 376 IPC),2014,1226,0,1226
Bihar,Custodial Rape,2014,0,0,0
Bihar,Gang Rape,2014,0,0,0
Bihar,Other Rape,2014,0,0,0
Bihar,Rape other than Custodial,2014,1226,0,1226
Bihar,Gang Rape,2014,49,0,49
Bihar,Other Rape,2014,1177,0,1177
Bihar,Attempt to commit Rape (Section 376/511 IPC),2014,497,3,500
Bihar,"Kidnapping & Abduction_Total (Section 3,364,364A, 366-369 IPC)",2014,7920,34,7954
Bihar,Kidnapping & Abduction (Section 363 IPC),2014,755,0,755
Bihar,Kidnaping & Abduction in order to Murder (Section 364 IPC),2014,888,2,890
Bihar,Kidnapping for Ransom (Section 364A IPC),2014,143,0,143
Bihar,Kidnapping & Abduction of Women to compel her for marriage (Section 366 IPC),2014,5245,25,5270
Bihar,Other Kidnapping,2014,889,7,896
Bihar,"Dacoity (Section 395,396-398 IPC)",2014,2099,0,2099
Bihar,Dacoity with Murder (Section 396 IPC),2014,24,0,24
Bihar,Other Dacoity,2014,2075,0,2075
Bihar,Making Preparation and Assembly for committing Dacoity (Section 399 & 402 IPC),2014,246,0,246
Bihar,"Robbery (Section 392 to 394, 397 and 398 IPC)",2014,3085,0,3085
Bihar,Criminal Trespass/Burglary_Total (Section 453 to 460 IPC),2014,4321,0,4321
Bihar,"Criminal Trespass/Burglary (Section 455, 457 & 458 IPC)",2014,4154,0,4154
Bihar,"House Trespass & House Breaking (Section 453,454,456,459 & 460 IPC)",2014,167,0,167
Bihar,Theft (Section 379 to 382 IPC),2014,17159,29,17188
Bihar,Auto Theft,2014,6584,0,6584
Bihar,Other Thefts,2014,10575,29,10604
Bihar,"Unlawful Assembly (Section 143,144 & 145)",2014,1647,0,1647
Bihar,"Riots (Section 147, 148, 149, 150 & 151 IPC)",2014,52326,1246,53572
Bihar,Communal,2014,384,0,384
Bihar,Industrial,2014,0,0,0
Bihar,Political,2014,23,2,25
Bihar,Caste Conflict,2014,50,0,50
Bihar,SC/STs Vs. Non-SCs/STs,2014,0,0,0
Bihar,Other Caste Riots,2014,50,0,50
Bihar,Agrarian,2014,972,23,995
Bihar,Students,2014,68,0,68
Bihar,Sectarian,2014,0,0,0
Bihar,Other Riots,2014,50829,1221,52050
Bihar,Criminal Breach of Trust (Section 406 to 409 IPC),2014,1564,5,1569
Bihar,Cheating (Section 420 IPC),2014,5921,34,5955
Bihar,"Forgery (Section 465, 468 & 471 IPC)",2014,1034,16,1050
Bihar,"Counterfeiting (Section 231-235,237-240, 242-243, 255 and 489-A to 489-E IPC)",2014,326,0,326
Bihar,"Offences related to Counterfeit Coin (Section 231-235,237, 238-240 & 242-243 IPC)",2014,299,0,299
Bihar,Counterfeiting Government Stamp (Section 255 IPC),2014,0,0,0
Bihar,Counterfeit currency & Bank notes (Section 489-A to 489-E IPC),2014,27,0,27
Bihar,Counterfeiting currency notes or Bank notes (Section 489A IPC),2014,18,0,18
Bihar,Using forged or counterfeit currency/Bank notes (Section 489B IPC),2014,6,0,6
Bihar,Possession of forged or counterfeiting currency / Bank notes (Section 489C IPC),2014,3,0,3
Bihar,Make/Possess materials for forging or counterfeiting currency/Bank notes (Section 489D IPC),2014,0,0,0
Bihar,Make/Use documents resembling currency notes/Bank notes (Section 489 E IPC),2014,0,0,0
Bihar,Arson (Section 435-436 & 438 IPC),2014,839,2,841
Bihar,"Grievous Hurt (Section 325,326,326A & 326 B IPC)",2014,22876,1404,24280
Bihar,Grievous Hurt (Section 325 & 326 IPC),2014,22871,1404,24275
Bihar,Acid attack (Section 326A IPC),2014,5,0,5
Bihar,Attempt to Acid Attack (Section 326B IPC),2014,0,0,0
Bihar,Dowry Deaths (Section 304-B IPC),2014,2119,265,2384
Bihar,Assault on women with intent to outrage her Modesty (Section 354 IPC),2014,732,1,733
Bihar,Sexual Harassment (Section 354A IPC),2014,371,1,372
Bihar,Assault on women with intent to Disrobe (Section 354B IPC),2014,91,0,91
Bihar,Voyeurism (Section 354C IPC),2014,5,0,5
Bihar,Stalking (Section 354D IPC),2014,8,0,8
Bihar,Others,2014,257,0,257
Bihar,Insult to the Modesty of Women (Section 509 IPC),2014,82,0,82
Bihar,At Office premises,2014,0,0,0
Bihar,Places related to work other than Office,2014,0,0,0
Bihar,In Public Transport system,2014,0,0,0
Bihar,In Other Places,2014,82,0,82
Bihar,Cruelty by Husband or his Relatives (Section 498-A IPC),2014,5152,845,5997
Bihar,Importation of Girls from Foreign Country (Section 366-B IPC),2014,19,0,19
Bihar,Causing Death by Negligence (Section 304-A IPC),2014,4901,52,4953
Bihar,Deaths due to negligent driving/act,2014,4477,52,4529
Bihar,Deaths due to Other Causes,2014,424,0,424
Bihar,"Offences against State (Section 121, 121A, 122, 123, 124-A IPC)",2014,35,0,35
Bihar,Sedition (Section 124A IPC),2014,28,0,28
Bihar,Other offences against State,2014,7,0,7
Bihar,Offences promoting enmity between different groups (Section 153A & 153B IPC),2014,0,0,0
Bihar,Promoting enmity on ground of religion race and place of Birth (Section 153A IPC),2014,0,0,0
Bihar,Imputation & assertions prejudicial to national integration (Section 153B IPC),2014,0,0,0
Bihar,Extortion (Section 384 - 389 IPC),2014,1206,0,1206
Bihar,Disclosure of Identity of Victims (Section 228 A IPC),2014,0,0,0
Bihar,Incidence of Rash Driving (Section 279 IPC Read with 337 & 338),2014,3415,27,3442
Bihar,Human Trafficking (Section 370 & 370A IPC),2014,79,0,79
Bihar,Unnatural Offences U/s 377 IPC,2014,5,0,5
Bihar,Other IPC crimes,2014,97319,4499,101818
Bihar,Total Cognizable IPC crimes,2014,250192,8962,259154
Chhattisgarh,Murder (Section 302 IPC),2014,1517,103,1620
Chhattisgarh,Attempt to commit Murder (Section 307 IPC),2014,1249,43,1292
Chhattisgarh,Culpable Homicide not amounting to Murder (Section 304 IPC),2014,48,2,50
Chhattisgarh,Attempt to commit Culpable Homicide (Section 308 IPC),2014,0,0,0
Chhattisgarh,Rape (Section 376 IPC),2014,1683,25,1708
Chhattisgarh,Custodial Rape,2014,0,0,0
Chhattisgarh,Gang Rape,2014,0,0,0
Chhattisgarh,Other Rape,2014,0,0,0
Chhattisgarh,Rape other than Custodial,2014,1683,25,1708
Chhattisgarh,Gang Rape,2014,192,3,195
Chhattisgarh,Other Rape,2014,1491,22,1513
Chhattisgarh,Attempt to commit Rape (Section 376/511 IPC),2014,22,1,23
Chhattisgarh,"Kidnapping & Abduction_Total (Section 3,364,364A, 366-369 IPC)",2014,1119,52,1171
Chhattisgarh,Kidnapping & Abduction (Section 363 IPC),2014,547,15,562
Chhattisgarh,Kidnaping & Abduction in order to Murder (Section 364 IPC),2014,18,0,18
Chhattisgarh,Kidnapping for Ransom (Section 364A IPC),2014,15,0,15
Chhattisgarh,Kidnapping & Abduction of Women to compel her for marriage (Section 366 IPC),2014,239,3,242
Chhattisgarh,Other Kidnapping,2014,300,34,334
Chhattisgarh,"Dacoity (Section 395,396-398 IPC)",2014,193,0,193
Chhattisgarh,Dacoity with Murder (Section 396 IPC),2014,6,0,6
Chhattisgarh,Other Dacoity,2014,187,0,187
Chhattisgarh,Making Preparation and Assembly for committing Dacoity (Section 399 & 402 IPC),2014,35,0,35
Chhattisgarh,"Robbery (Section 392 to 394, 397 and 398 IPC)",2014,665,5,670
Chhattisgarh,Criminal Trespass/Burglary_Total (Section 453 to 460 IPC),2014,2227,22,2249
Chhattisgarh,"Criminal Trespass/Burglary (Section 455, 457 & 458 IPC)",2014,1668,8,1676
Chhattisgarh,"House Trespass & House Breaking (Section 453,454,456,459 & 460 IPC)",2014,559,14,573
Chhattisgarh,Theft (Section 379 to 382 IPC),2014,4012,114,4126
Chhattisgarh,Auto Theft,2014,1529,0,1529
Chhattisgarh,Other Thefts,2014,2483,114,2597
Chhattisgarh,"Unlawful Assembly (Section 143,144 & 145)",2014,369,4,373
Chhattisgarh,"Riots (Section 147, 148, 149, 150 & 151 IPC)",2014,4076,310,4386
Chhattisgarh,Communal,2014,0,0,0
Chhattisgarh,Industrial,2014,6,0,6
Chhattisgarh,Political,2014,25,0,25
Chhattisgarh,Caste Conflict,2014,703,29,732
Chhattisgarh,SC/STs Vs. Non-SCs/STs,2014,36,0,36
Chhattisgarh,Other Caste Riots,2014,667,29,696
Chhattisgarh,Agrarian,2014,38,4,42
Chhattisgarh,Students,2014,5,0,5
Chhattisgarh,Sectarian,2014,0,0,0
Chhattisgarh,Other Riots,2014,3299,277,3576
Chhattisgarh,Criminal Breach of Trust (Section 406 to 409 IPC),2014,206,2,208
Chhattisgarh,Cheating (Section 420 IPC),2014,973,48,1021
Chhattisgarh,"Forgery (Section 465, 468 & 471 IPC)",2014,72,0,72
Chhattisgarh,"Counterfeiting (Section 231-235,237-240, 242-243, 255 and 489-A to 489-E IPC)",2014,38,0,38
Chhattisgarh,"Offences related to Counterfeit Coin (Section 231-235,237, 238-240 & 242-243 IPC)",2014,0,0,0
Chhattisgarh,Counterfeiting Government Stamp (Section 255 IPC),2014,0,0,0
Chhattisgarh,Counterfeit currency & Bank notes (Section 489-A to 489-E IPC),2014,38,0,38
Chhattisgarh,Counterfeiting currency notes or Bank notes (Section 489A IPC),2014,26,0,26
Chhattisgarh,Using forged or counterfeit currency/Bank notes (Section 489B IPC),2014,12,0,12
Chhattisgarh,Possession of forged or counterfeiting currency / Bank notes (Section 489C IPC),2014,0,0,0
Chhattisgarh,Make/Possess materials for forging or counterfeiting currency/Bank notes (Section 489D IPC),2014,0,0,0
Chhattisgarh,Make/Use documents resembling currency notes/Bank notes (Section 489 E IPC),2014,0,0,0
Chhattisgarh,Arson (Section 435-436 & 438 IPC),2014,299,3,302
Chhattisgarh,"Grievous Hurt (Section 325,326,326A & 326 B IPC)",2014,5288,436,5724
Chhattisgarh,Grievous Hurt (Section 325 & 326 IPC),2014,5285,436,5721
Chhattisgarh,Acid attack (Section 326A IPC),2014,3,0,3
Chhattisgarh,Attempt to Acid Attack (Section 326B IPC),2014,0,0,0
Chhattisgarh,Dowry Deaths (Section 304-B IPC),2014,240,97,337
Chhattisgarh,Assault on women with intent to outrage her Modesty (Section 354 IPC),2014,3062,5,3067
Chhattisgarh,Sexual Harassment (Section 354A IPC),2014,696,0,696
Chhattisgarh,Assault on women with intent to Disrobe (Section 354B IPC),2014,87,2,89
Chhattisgarh,Voyeurism (Section 354C IPC),2014,13,0,13
Chhattisgarh,Stalking (Section 354D IPC),2014,192,0,192
Chhattisgarh,Others,2014,2074,3,2077
Chhattisgarh,Insult to the Modesty of Women (Section 509 IPC),2014,91,1,92
Chhattisgarh,At Office premises,2014,0,0,0
Chhattisgarh,Places related to work other than Office,2014,13,0,13
Chhattisgarh,In Public Transport system,2014,0,0,0
Chhattisgarh,In Other Places,2014,78,1,79
Chhattisgarh,Cruelty by Husband or his Relatives (Section 498-A IPC),2014,1816,715,2531
Chhattisgarh,Importation of Girls from Foreign Country (Section 366-B IPC),2014,0,0,0
Chhattisgarh,Causing Death by Negligence (Section 304-A IPC),2014,2671,6,2677
Chhattisgarh,Deaths due to negligent driving/act,2014,2307,3,2310
Chhattisgarh,Deaths due to Other Causes,2014,364,3,367
Chhattisgarh,"Offences against State (Section 121, 121A, 122, 123, 124-A IPC)",2014,7,0,7
Chhattisgarh,Sedition (Section 124A IPC),2014,1,0,1
Chhattisgarh,Other offences against State,2014,6,0,6
Chhattisgarh,Offences promoting enmity between different groups (Section 153A & 153B IPC),2014,2,0,2
Chhattisgarh,Promoting enmity on ground of religion race and place of Birth (Section 153A IPC),2014,2,0,2
Chhattisgarh,Imputation & assertions prejudicial to national integration (Section 153B IPC),2014,0,0,0
Chhattisgarh,Extortion (Section 384 - 389 IPC),2014,96,3,99
Chhattisgarh,Disclosure of Identity of Victims (Section 228 A IPC),2014,0,0,0
Chhattisgarh,Incidence of Rash Driving (Section 279 IPC Read with 337 & 338),2014,7115,35,7150
Chhattisgarh,Human Trafficking (Section 370 & 370A IPC),2014,46,33,79
Chhattisgarh,Unnatural Offences U/s 377 IPC,2014,23,0,23
Chhattisgarh,Other IPC crimes,2014,31432,2613,34045
Chhattisgarh,Total Cognizable IPC crimes,2014,70692,4678,75370
Goa,Murder (Section 302 IPC),2014,45,1,46
Goa,Attempt to commit Murder (Section 307 IPC),2014,82,4,86
Goa,Culpable Homicide not amounting to Murder (Section 304 IPC),2014,27,0,27
Goa,Attempt to commit Culpable Homicide (Section 308 IPC),2014,0,0,0
Goa,Rape (Section 376 IPC),2014,99,6,105
Goa,Custodial Rape,2014,0,0,0
Goa,Gang Rape,2014,0,0,0
Goa,Other Rape,2014,0,0,0
Goa,Rape other than Custodial,2014,99,6,105
Goa,Gang Rape,2014,5,0,5
Goa,Other Rape,2014,94,6,100
Goa,Attempt to commit Rape (Section 376/511 IPC),2014,3,0,3
Goa,"Kidnapping & Abduction_Total (Section 3,364,364A, 366-369 IPC)",2014,49,6,55
Goa,Kidnapping & Abduction (Section 363 IPC),2014,39,6,45
Goa,Kidnaping & Abduction in order to Murder (Section 364 IPC),2014,0,0,0
Goa,Kidnapping for Ransom (Section 364A IPC),2014,3,0,3
Goa,Kidnapping & Abduction of Women to compel her for marriage (Section 366 IPC),2014,0,0,0
Goa,Other Kidnapping,2014,7,0,7
Goa,"Dacoity (Section 395,396-398 IPC)",2014,33,0,33
Goa,Dacoity with Murder (Section 396 IPC),2014,0,0,0
Goa,Other Dacoity,2014,33,0,33
Goa,Making Preparation and Assembly for committing Dacoity (Section 399 & 402 IPC),2014,0,0,0
Goa,"Robbery (Section 392 to 394, 397 and 398 IPC)",2014,40,4,44
Goa,Criminal Trespass/Burglary_Total (Section 453 to 460 IPC),2014,249,23,272
Goa,"Criminal Trespass/Burglary (Section 455, 457 & 458 IPC)",2014,201,9,210
Goa,"House Trespass & House Breaking (Section 453,454,456,459 & 460 IPC)",2014,48,14,62
Goa,Theft (Section 379 to 382 IPC),2014,586,60,646
Goa,Auto Theft,2014,145,1,146
Goa,Other Thefts,2014,441,59,500
Goa,"Unlawful Assembly (Section 143,144 & 145)",2014,60,7,67
Goa,"Riots (Section 147, 148, 149, 150 & 151 IPC)",2014,472,46,518
Goa,Communal,2014,0,0,0
Goa,Industrial,2014,0,0,0
Goa,Political,2014,0,0,0
Goa,Caste Conflict,2014,0,0,0
Goa,SC/STs Vs. Non-SCs/STs,2014,0,0,0
Goa,Other Caste Riots,2014,0,0,0
Goa,Agrarian,2014,0,0,0
Goa,Students,2014,0,0,0
Goa,Sectarian,2014,0,0,0
Goa,Other Riots,2014,472,46,518
Goa,Criminal Breach of Trust (Section 406 to 409 IPC),2014,46,0,46
Goa,Cheating (Section 420 IPC),2014,141,13,154
Goa,"Forgery (Section 465, 468 & 471 IPC)",2014,3,0,3
Goa,"Counterfeiting (Section 231-235,237-240, 242-243, 255 and 489-A to 489-E IPC)",2014,4,1,5
Goa,"Offences related to Counterfeit Coin (Section 231-235,237, 238-240 & 242-243 IPC)",2014,0,0,0
Goa,Counterfeiting Government Stamp (Section 255 IPC),2014,0,0,0
Goa,Counterfeit currency & Bank notes (Section 489-A to 489-E IPC),2014,4,1,5
Goa,Counterfeiting currency notes or Bank notes (Section 489A IPC),2014,4,1,5
Goa,Using forged or counterfeit currency/Bank notes (Section 489B IPC),2014,0,0,0
Goa,Possession of forged or counterfeiting currency / Bank notes (Section 489C IPC),2014,0,0,0
Goa,Make/Possess materials for forging or counterfeiting currency/Bank notes (Section 489D IPC),2014,0,0,0
Goa,Make/Use documents resembling currency notes/Bank notes (Section 489 E IPC),2014,0,0,0
Goa,Arson (Section 435-436 & 438 IPC),2014,34,1,35
Goa,"Grievous Hurt (Section 325,326,326A & 326 B IPC)",2014,157,6,163
Goa,Grievous Hurt (Section 325 & 326 IPC),2014,157,6,163
Goa,Acid attack (Section 326A IPC),2014,0,0,0
Goa,Attempt to Acid Attack (Section 326B IPC),2014,0,0,0
Goa,Dowry Deaths (Section 304-B IPC),2014,0,0,0
Goa,Assault on women with intent to outrage her Modesty (Section 354 IPC),2014,182,6,188
Goa,Sexual Harassment (Section 354A IPC),2014,55,1,56
Goa,Assault on women with intent to Disrobe (Section 354B IPC),2014,4,0,4
Goa,Voyeurism (Section 354C IPC),2014,7,0,7
Goa,Stalking (Section 354D IPC),2014,19,0,19
Goa,Others,2014,97,5,102
Goa,Insult to the Modesty of Women (Section 509 IPC),2014,45,2,47
Goa,At Office premises,2014,1,0,1
Goa,Places related to work other than Office,2014,0,0,0
Goa,In Public Transport system,2014,0,0,0
Goa,In Other Places,2014,44,2,46
Goa,Cruelty by Husband or his Relatives (Section 498-A IPC),2014,26,12,38
Goa,Importation of Girls from Foreign Country (Section 366-B IPC),2014,0,0,0
Goa,Causing Death by Negligence (Section 304-A IPC),2014,162,3,165
Goa,Deaths due to negligent driving/act,2014,157,3,160
Goa,Deaths due to Other Causes,2014,5,0,5
Goa,"Offences against State (Section 121, 121A, 122, 123, 124-A IPC)",2014,0,0,0
Goa,Sedition (Section 124A IPC),2014,0,0,0
Goa,Other offences against State,2014,0,0,0
Goa,Offences promoting enmity between different groups (Section 153A & 153B IPC),2014,0,0,0
Goa,Promoting enmity on ground of religion race and place of Birth (Section 153A IPC),2014,0,0,0
Goa,Imputation & assertions prejudicial to national integration (Section 153B IPC),2014,0,0,0
Goa,Extortion (Section 384 - 389 IPC),2014,23,1,24
Goa,Disclosure of Identity of Victims (Section 228 A IPC),2014,0,0,0
Goa,Incidence of Rash Driving (Section 279 IPC Read with 337 & 338),2014,506,8,514
Goa,Human Trafficking (Section 370 & 370A IPC),2014,55,5,60
Goa,Unnatural Offences U/s 377 IPC,2014,0,0,0
Goa,Other IPC crimes,2014,666,47,713
Goa,Total Cognizable IPC crimes,2014,3795,262,4057
Gujarat,Murder (Section 302 IPC),2014,2306,185,2491
Gujarat,Attempt to commit Murder (Section 307 IPC),2014,2845,163,3008
Gujarat,Culpable Homicide not amounting to Murder (Section 304 IPC),2014,96,7,103
Gujarat,Attempt to commit Culpable Homicide (Section 308 IPC),2014,13,0,13
Gujarat,Rape (Section 376 IPC),2014,1133,71,1204
Gujarat,Custodial Rape,2014,0,0,0
Gujarat,Gang Rape,2014,0,0,0
Gujarat,Other Rape,2014,0,0,0
Gujarat,Rape other than Custodial,2014,1133,71,1204
Gujarat,Gang Rape,2014,66,0,66
Gujarat,Other Rape,2014,1067,71,1138
Gujarat,Attempt to commit Rape (Section 376/511 IPC),2014,7,0,7
Gujarat,"Kidnapping & Abduction_Total (Section 3,364,364A, 366-369 IPC)",2014,2879,117,2996
Gujarat,Kidnapping & Abduction (Section 363 IPC),2014,711,33,744
Gujarat,Kidnaping & Abduction in order to Murder (Section 364 IPC),2014,0,0,0
Gujarat,Kidnapping for Ransom (Section 364A IPC),2014,105,4,109
Gujarat,Kidnapping & Abduction of Women to compel her for marriage (Section 366 IPC),2014,1473,57,1530
Gujarat,Other Kidnapping,2014,590,23,613
Gujarat,"Dacoity (Section 395,396-398 IPC)",2014,1387,44,1431
Gujarat,Dacoity with Murder (Section 396 IPC),2014,0,0,0
Gujarat,Other Dacoity,2014,1387,44,1431
Gujarat,Making Preparation and Assembly for committing Dacoity (Section 399 & 402 IPC),2014,76,1,77
Gujarat,"Robbery (Section 392 to 394, 397 and 398 IPC)",2014,1789,23,1812
Gujarat,Criminal Trespass/Burglary_Total (Section 453 to 460 IPC),2014,3234,49,3283
Gujarat,"Criminal Trespass/Burglary (Section 455, 457 & 458 IPC)",2014,1255,16,1271
Gujarat,"House Trespass & House Breaking (Section 453,454,456,459 & 460 IPC)",2014,1979,33,2012
Gujarat,Theft (Section 379 to 382 IPC),2014,9957,256,10213
Gujarat,Auto Theft,2014,3815,3,3818
Gujarat,Other Thefts,2014,6142,253,6395
Gujarat,"Unlawful Assembly (Section 143,144 & 145)",2014,1474,133,1607
Gujarat,"Riots (Section 147, 148, 149, 150 & 151 IPC)",2014,9262,671,9933
Gujarat,Communal,2014,786,7,793
Gujarat,Industrial,2014,15,0,15
Gujarat,Political,2014,108,7,115
Gujarat,Caste Conflict,2014,750,71,821
Gujarat,SC/STs Vs. Non-SCs/STs,2014,232,25,257
Gujarat,Other Caste Riots,2014,518,46,564
Gujarat,Agrarian,2014,408,29,437
Gujarat,Students,2014,12,0,12
Gujarat,Sectarian,2014,19,0,19
Gujarat,Other Riots,2014,7164,557,7721
Gujarat,Criminal Breach of Trust (Section 406 to 409 IPC),2014,1645,199,1844
Gujarat,Cheating (Section 420 IPC),2014,2074,192,2266
Gujarat,"Forgery (Section 465, 468 & 471 IPC)",2014,441,12,453
Gujarat,"Counterfeiting (Section 231-235,237-240, 242-243, 255 and 489-A to 489-E IPC)",2014,57,8,65
Gujarat,"Offences related to Counterfeit Coin (Section 231-235,237, 238-240 & 242-243 IPC)",2014,4,0,4
Gujarat,Counterfeiting Government Stamp (Section 255 IPC),2014,0,0,0
Gujarat,Counterfeit currency & Bank notes (Section 489-A to 489-E IPC),2014,53,8,61
Gujarat,Counterfeiting currency notes or Bank notes (Section 489A IPC),2014,34,8,42
Gujarat,Using forged or counterfeit currency/Bank notes (Section 489B IPC),2014,3,0,3
Gujarat,Possession of forged or counterfeiting currency / Bank notes (Section 489C IPC),2014,15,0,15
Gujarat,Make/Possess materials for forging or counterfeiting currency/Bank notes (Section 489D IPC),2014,0,0,0
Gujarat,Make/Use documents resembling currency notes/Bank notes (Section 489 E IPC),2014,1,0,1
Gujarat,Arson (Section 435-436 & 438 IPC),2014,396,15,411
Gujarat,"Grievous Hurt (Section 325,326,326A & 326 B IPC)",2014,6787,437,7224
Gujarat,Grievous Hurt (Section 325 & 326 IPC),2014,6777,435,7212
Gujarat,Acid attack (Section 326A IPC),2014,7,2,9
Gujarat,Attempt to Acid Attack (Section 326B IPC),2014,3,0,3
Gujarat,Dowry Deaths (Section 304-B IPC),2014,43,16,59
Gujarat,Assault on women with intent to outrage her Modesty (Section 354 IPC),2014,1934,82,2016
Gujarat,Sexual Harassment (Section 354A IPC),2014,559,19,578
Gujarat,Assault on women with intent to Disrobe (Section 354B IPC),2014,74,4,78
Gujarat,Voyeurism (Section 354C IPC),2014,10,0,10
Gujarat,Stalking (Section 354D IPC),2014,78,4,82
Gujarat,Others,2014,1213,55,1268
Gujarat,Insult to the Modesty of Women (Section 509 IPC),2014,191,4,195
Gujarat,At Office premises,2014,1,0,1
Gujarat,Places related to work other than Office,2014,3,0,3
Gujarat,In Public Transport system,2014,0,0,0
Gujarat,In Other Places,2014,187,4,191
Gujarat,Cruelty by Husband or his Relatives (Section 498-A IPC),2014,12904,6305,19209
Gujarat,Importation of Girls from Foreign Country (Section 366-B IPC),2014,0,0,0
Gujarat,Causing Death by Negligence (Section 304-A IPC),2014,5429,17,5446
Gujarat,Deaths due to negligent driving/act,2014,5351,16,5367
Gujarat,Deaths due to Other Causes,2014,78,1,79
Gujarat,"Offences against State (Section 121, 121A, 122, 123, 124-A IPC)",2014,0,0,0
Gujarat,Sedition (Section 124A IPC),2014,0,0,0
Gujarat,Other offences against State,2014,0,0,0
Gujarat,Offences promoting enmity between different groups (Section 153A & 153B IPC),2014,22,0,22
Gujarat,Promoting enmity on ground of religion race and place of Birth (Section 153A IPC),2014,21,0,21
Gujarat,Imputation & assertions prejudicial to national integration (Section 153B IPC),2014,1,0,1
Gujarat,Extortion (Section 384 - 389 IPC),2014,354,18,372
Gujarat,Disclosure of Identity of Victims (Section 228 A IPC),2014,0,0,0
Gujarat,Incidence of Rash Driving (Section 279 IPC Read with 337 & 338),2014,28967,141,29108
Gujarat,Human Trafficking (Section 370 & 370A IPC),2014,11,0,11
Gujarat,Unnatural Offences U/s 377 IPC,2014,28,1,29
Gujarat,Other IPC crimes,2014,69053,4985,74038
Gujarat,Total Cognizable IPC crimes,2014,166794,14152,180946
Haryana,Murder (Section 302 IPC),2014,1826,104,1930
Haryana,Attempt to commit Murder (Section 307 IPC),2014,1515,35,1550
Haryana,Culpable Homicide not amounting to Murder (Section 304 IPC),2014,84,0,84
Haryana,Attempt to commit Culpable Homicide (Section 308 IPC),2014,8,0,8
Haryana,Rape (Section 376 IPC),2014,1416,40,1456
Haryana,Custodial Rape,2014,0,0,0
Haryana,Gang Rape,2014,0,0,0
Haryana,Other Rape,2014,0,0,0
Haryana,Rape other than Custodial,2014,1416,40,1456
Haryana,Gang Rape,2014,444,7,451
Haryana,Other Rape,2014,972,33,1005
Haryana,Attempt to commit Rape (Section 376/511 IPC),2014,134,5,139
Haryana,"Kidnapping & Abduction_Total (Section 3,364,364A, 366-369 IPC)",2014,1423,26,1449
Haryana,Kidnapping & Abduction (Section 363 IPC),2014,61,0,61
Haryana,Kidnaping & Abduction in order to Murder (Section 364 IPC),2014,37,3,40
Haryana,Kidnapping for Ransom (Section 364A IPC),2014,22,1,23
Haryana,Kidnapping & Abduction of Women to compel her for marriage (Section 366 IPC),2014,525,5,530
Haryana,Other Kidnapping,2014,778,17,795
Haryana,"Dacoity (Section 395,396-398 IPC)",2014,505,0,505
Haryana,Dacoity with Murder (Section 396 IPC),2014,6,0,6
Haryana,Other Dacoity,2014,499,0,499
Haryana,Making Preparation and Assembly for committing Dacoity (Section 399 & 402 IPC),2014,395,0,395
Haryana,"Robbery (Section 392 to 394, 397 and 398 IPC)",2014,1392,0,1392
Haryana,Criminal Trespass/Burglary_Total (Section 453 to 460 IPC),2014,3243,54,3297
Haryana,"Criminal Trespass/Burglary (Section 455, 457 & 458 IPC)",2014,2771,33,2804
Haryana,"House Trespass & House Breaking (Section 453,454,456,459 & 460 IPC)",2014,472,21,493
Haryana,Theft (Section 379 to 382 IPC),2014,6708,76,6784
Haryana,Auto Theft,2014,3636,0,3636
Haryana,Other Thefts,2014,3072,76,3148
Haryana,"Unlawful Assembly (Section 143,144 & 145)",2014,0,0,0
Haryana,"Riots (Section 147, 148, 149, 150 & 151 IPC)",2014,6540,261,6801
Haryana,Communal,2014,763,0,763
Haryana,Industrial,2014,0,0,0
Haryana,Political,2014,0,0,0
Haryana,Caste Conflict,2014,181,23,204
Haryana,SC/STs Vs. Non-SCs/STs,2014,0,0,0
Haryana,Other Caste Riots,2014,181,23,204
Haryana,Agrarian,2014,0,0,0
Haryana,Students,2014,0,0,0
Haryana,Sectarian,2014,0,0,0
Haryana,Other Riots,2014,5596,238,5834
Haryana,Criminal Breach of Trust (Section 406 to 409 IPC),2014,547,13,560
Haryana,Cheating (Section 420 IPC),2014,1346,49,1395
Haryana,"Forgery (Section 465, 468 & 471 IPC)",2014,568,15,583
Haryana,"Counterfeiting (Section 231-235,237-240, 242-243, 255 and 489-A to 489-E IPC)",2014,42,1,43
Haryana,"Offences related to Counterfeit Coin (Section 231-235,237, 238-240 & 242-243 IPC)",2014,0,0,0
Haryana,Counterfeiting Government Stamp (Section 255 IPC),2014,0,0,0
Haryana,Counterfeit currency & Bank notes (Section 489-A to 489-E IPC),2014,42,1,43
Haryana,Counterfeiting currency notes or Bank notes (Section 489A IPC),2014,18,1,19
Haryana,Using forged or counterfeit currency/Bank notes (Section 489B IPC),2014,17,0,17
Haryana,Possession of forged or counterfeiting currency / Bank notes (Section 489C IPC),2014,7,0,7
Haryana,Make/Possess materials for forging or counterfeiting currency/Bank notes (Section 489D IPC),2014,0,0,0
Haryana,Make/Use documents resembling currency notes/Bank notes (Section 489 E IPC),2014,0,0,0
Haryana,Arson (Section 435-436 & 438 IPC),2014,178,7,185
Haryana,"Grievous Hurt (Section 325,326,326A & 326 B IPC)",2014,3052,218,3270
Haryana,Grievous Hurt (Section 325 & 326 IPC),2014,3037,217,3254
Haryana,Acid attack (Section 326A IPC),2014,11,1,12
Haryana,Attempt to Acid Attack (Section 326B IPC),2014,4,0,4
Haryana,Dowry Deaths (Section 304-B IPC),2014,443,125,568
Haryana,Assault on women with intent to outrage her Modesty (Section 354 IPC),2014,2062,18,2080
Haryana,Sexual Harassment (Section 354A IPC),2014,698,3,701
Haryana,Assault on women with intent to Disrobe (Section 354B IPC),2014,245,1,246
Haryana,Voyeurism (Section 354C IPC),2014,26,0,26
Haryana,Stalking (Section 354D IPC),2014,300,0,300
Haryana,Others,2014,793,14,807
Haryana,Insult to the Modesty of Women (Section 509 IPC),2014,93,1,94
Haryana,At Office premises,2014,0,0,0
Haryana,Places related to work other than Office,2014,1,0,1
Haryana,In Public Transport system,2014,1,0,1
Haryana,In Other Places,2014,91,1,92
Haryana,Cruelty by Husband or his Relatives (Section 498-A IPC),2014,3402,803,4205
Haryana,Importation of Girls from Foreign Country (Section 366-B IPC),2014,0,0,0
Haryana,Causing Death by Negligence (Section 304-A IPC),2014,3458,3,3461
Haryana,Deaths due to negligent driving/act,2014,3315,1,3316
Haryana,Deaths due to Other Causes,2014,143,2,145
Haryana,"Offences against State (Section 121, 121A, 122, 123, 124-A IPC)",2014,0,0,0
Haryana,Sedition (Section 124A IPC),2014,0,0,0
Haryana,Other offences against State,2014,0,0,0
Haryana,Offences promoting enmity between different groups (Section 153A & 153B IPC),2014,0,0,0
Haryana,Promoting enmity on ground of religion race and place of Birth (Section 153A IPC),2014,0,0,0
Haryana,Imputation & assertions prejudicial to national integration (Section 153B IPC),2014,0,0,0
Haryana,Extortion (Section 384 - 389 IPC),2014,243,26,269
Haryana,Disclosure of Identity of Victims (Section 228 A IPC),2014,0,0,0
Haryana,Incidence of Rash Driving (Section 279 IPC Read with 337 & 338),2014,5115,8,5123
Haryana,Human Trafficking (Section 370 & 370A IPC),2014,14,5,19
Haryana,Unnatural Offences U/s 377 IPC,2014,152,0,152
Haryana,Other IPC crimes,2014,28605,966,29571
Haryana,Total Cognizable IPC crimes,2014,74509,2859,77368
Himachal Pradesh,Murder (Section 302 IPC),2014,181,22,203
Himachal Pradesh,Attempt to commit Murder (Section 307 IPC),2014,116,10,126
Himachal Pradesh,Culpable Homicide not amounting to Murder (Section 304 IPC),2014,12,1,13
Himachal Pradesh,Attempt to commit Culpable Homicide (Section 308 IPC),2014,0,0,0
Himachal Pradesh,Rape (Section 376 IPC),2014,317,12,329
Himachal Pradesh,Custodial Rape,2014,0,0,0
Himachal Pradesh,Gang Rape,2014,0,0,0
Himachal Pradesh,Other Rape,2014,0,0,0
Himachal Pradesh,Rape other than Custodial,2014,317,12,329
Himachal Pradesh,Gang Rape,2014,19,0,19
Himachal Pradesh,Other Rape,2014,298,12,310
Himachal Pradesh,Attempt to commit Rape (Section 376/511 IPC),2014,4,0,4
Himachal Pradesh,"Kidnapping & Abduction_Total (Section 3,364,364A, 366-369 IPC)",2014,108,5,113
Himachal Pradesh,Kidnapping & Abduction (Section 363 IPC),2014,15,0,15
Himachal Pradesh,Kidnaping & Abduction in order to Murder (Section 364 IPC),2014,0,0,0
Himachal Pradesh,Kidnapping for Ransom (Section 364A IPC),2014,2,0,2
Himachal Pradesh,Kidnapping & Abduction of Women to compel her for marriage (Section 366 IPC),2014,63,2,65
Himachal Pradesh,Other Kidnapping,2014,28,3,31
Himachal Pradesh,"Dacoity (Section 395,396-398 IPC)",2014,11,1,12
Himachal Pradesh,Dacoity with Murder (Section 396 IPC),2014,0,0,0
Himachal Pradesh,Other Dacoity,2014,11,1,12
Himachal Pradesh,Making Preparation and Assembly for committing Dacoity (Section 399 & 402 IPC),2014,0,0,0
Himachal Pradesh,"Robbery (Section 392 to 394, 397 and 398 IPC)",2014,27,0,27
Himachal Pradesh,Criminal Trespass/Burglary_Total (Section 453 to 460 IPC),2014,663,61,724
Himachal Pradesh,"Criminal Trespass/Burglary (Section 455, 457 & 458 IPC)",2014,244,6,250
Himachal Pradesh,"House Trespass & House Breaking (Section 453,454,456,459 & 460 IPC)",2014,419,55,474
Himachal Pradesh,Theft (Section 379 to 382 IPC),2014,599,23,622
Himachal Pradesh,Auto Theft,2014,130,0,130
Himachal Pradesh,Other Thefts,2014,469,23,492
Himachal Pradesh,"Unlawful Assembly (Section 143,144 & 145)",2014,83,2,85
Himachal Pradesh,"Riots (Section 147, 148, 149, 150 & 151 IPC)",2014,2042,467,2509
Himachal Pradesh,Communal,2014,0,0,0
Himachal Pradesh,Industrial,2014,0,0,0
Himachal Pradesh,Political,2014,29,0,29
Himachal Pradesh,Caste Conflict,2014,0,0,0
Himachal Pradesh,SC/STs Vs. Non-SCs/STs,2014,0,0,0
Himachal Pradesh,Other Caste Riots,2014,0,0,0
Himachal Pradesh,Agrarian,2014,0,0,0
Himachal Pradesh,Students,2014,110,24,134
Himachal Pradesh,Sectarian,2014,0,0,0
Himachal Pradesh,Other Riots,2014,1903,443,2346
Himachal Pradesh,Criminal Breach of Trust (Section 406 to 409 IPC),2014,100,2,102
Himachal Pradesh,Cheating (Section 420 IPC),2014,414,20,434
Himachal Pradesh,"Forgery (Section 465, 468 & 471 IPC)",2014,40,3,43
Himachal Pradesh,"Counterfeiting (Section 231-235,237-240, 242-243, 255 and 489-A to 489-E IPC)",2014,4,0,4
Himachal Pradesh,"Offences related to Counterfeit Coin (Section 231-235,237, 238-240 & 242-243 IPC)",2014,0,0,0
Himachal Pradesh,Counterfeiting Government Stamp (Section 255 IPC),2014,0,0,0
Himachal Pradesh,Counterfeit currency & Bank notes (Section 489-A to 489-E IPC),2014,4,0,4
Himachal Pradesh,Counterfeiting currency notes or Bank notes (Section 489A IPC),2014,0,0,0
Himachal Pradesh,Using forged or counterfeit currency/Bank notes (Section 489B IPC),2014,1,0,1
Himachal Pradesh,Possession of forged or counterfeiting currency / Bank notes (Section 489C IPC),2014,3,0,3
Himachal Pradesh,Make/Possess materials for forging or counterfeiting currency/Bank notes (Section 489D IPC),2014,0,0,0
Himachal Pradesh,Make/Use documents resembling currency notes/Bank notes (Section 489 E IPC),2014,0,0,0
Himachal Pradesh,Arson (Section 435-436 & 438 IPC),2014,84,7,91
Himachal Pradesh,"Grievous Hurt (Section 325,326,326A & 326 B IPC)",2014,848,158,1006
Himachal Pradesh,Grievous Hurt (Section 325 & 326 IPC),2014,847,158,1005
Himachal Pradesh,Acid attack (Section 326A IPC),2014,1,0,1
Himachal Pradesh,Attempt to Acid Attack (Section 326B IPC),2014,0,0,0
Himachal Pradesh,Dowry Deaths (Section 304-B IPC),2014,3,2,5
Himachal Pradesh,Assault on women with intent to outrage her Modesty (Section 354 IPC),2014,646,37,683
Himachal Pradesh,Sexual Harassment (Section 354A IPC),2014,185,4,189
Himachal Pradesh,Assault on women with intent to Disrobe (Section 354B IPC),2014,26,2,28
Himachal Pradesh,Voyeurism (Section 354C IPC),2014,3,0,3
Himachal Pradesh,Stalking (Section 354D IPC),2014,73,1,74
Himachal Pradesh,Others,2014,359,30,389
Himachal Pradesh,Insult to the Modesty of Women (Section 509 IPC),2014,54,5,59
Himachal Pradesh,At Office premises,2014,0,0,0
Himachal Pradesh,Places related to work other than Office,2014,0,0,0
Himachal Pradesh,In Public Transport system,2014,0,0,0
Himachal Pradesh,In Other Places,2014,54,5,59
Himachal Pradesh,Cruelty by Husband or his Relatives (Section 498-A IPC),2014,456,223,679
Himachal Pradesh,Importation of Girls from Foreign Country (Section 366-B IPC),2014,0,0,0
Himachal Pradesh,Causing Death by Negligence (Section 304-A IPC),2014,481,4,485
Himachal Pradesh,Deaths due to negligent driving/act,2014,435,2,437
Himachal Pradesh,Deaths due to Other Causes,2014,46,2,48
Himachal Pradesh,"Offences against State (Section 121, 121A, 122, 123, 124-A IPC)",2014,2,0,2
Himachal Pradesh,Sedition (Section 124A IPC),2014,2,0,2
Himachal Pradesh,Other offences against State,2014,0,0,0
Himachal Pradesh,Offences promoting enmity between different groups (Section 153A & 153B IPC),2014,0,0,0
Himachal Pradesh,Promoting enmity on ground of religion race and place of Birth (Section 153A IPC),2014,0,0,0
Himachal Pradesh,Imputation & assertions prejudicial to national integration (Section 153B IPC),2014,0,0,0
Himachal Pradesh,Extortion (Section 384 - 389 IPC),2014,5,1,6
Himachal Pradesh,Disclosure of Identity of Victims (Section 228 A IPC),2014,0,0,0
Himachal Pradesh,Incidence of Rash Driving (Section 279 IPC Read with 337 & 338),2014,2052,9,2061
Himachal Pradesh,Human Trafficking (Section 370 & 370A IPC),2014,1,0,1
Himachal Pradesh,Unnatural Offences U/s 377 IPC,2014,15,0,15
Himachal Pradesh,Other IPC crimes,2014,7713,1199,8912
Himachal Pradesh,Total Cognizable IPC crimes,2014,17081,2274,19355
Jammu & Kashmir,Murder (Section 302 IPC),2014,256,22,278
Jammu & Kashmir,Attempt to commit Murder (Section 307 IPC),2014,1076,31,1107
Jammu & Kashmir,Culpable Homicide not amounting to Murder (Section 304 IPC),2014,23,0,23
Jammu & Kashmir,Attempt to commit Culpable Homicide (Section 308 IPC),2014,0,0,0
Jammu & Kashmir,Rape (Section 376 IPC),2014,339,7,346
Jammu & Kashmir,Custodial Rape,2014,0,0,0
Jammu & Kashmir,Gang Rape,2014,0,0,0
Jammu & Kashmir,Other Rape,2014,0,0,0
Jammu & Kashmir,Rape other than Custodial,2014,339,7,346
Jammu & Kashmir,Other Rape,2014,339,7,346
Jammu & Kashmir,Attempt to commit Rape (Section 376/511 IPC),2014,17,0,17
Jammu & Kashmir,"Kidnapping & Abduction_Total (Section 3,364,364A, 366-369 IPC)",2014,750,22,772
Jammu & Kashmir,Kidnapping & Abduction (Section 363 IPC),2014,245,7,252
Jammu & Kashmir,Kidnaping & Abduction in order to Murder (Section 364 IPC),2014,12,0,12
Jammu & Kashmir,Kidnapping for Ransom (Section 364A IPC),2014,0,0,0
Jammu & Kashmir,Kidnapping & Abduction of Women to compel her for marriage (Section 366 IPC),2014,200,1,201
Jammu & Kashmir,Other Kidnapping,2014,293,14,307
Jammu & Kashmir,"Dacoity (Section 395,396-398 IPC)",2014,21,5,26
Jammu & Kashmir,Dacoity with Murder (Section 396 IPC),2014,0,0,0
Jammu & Kashmir,Other Dacoity,2014,21,5,26
Jammu & Kashmir,Making Preparation and Assembly for committing Dacoity (Section 399 & 402 IPC),2014,0,0,0
Jammu & Kashmir,"Robbery (Section 392 to 394, 397 and 398 IPC)",2014,101,0,101
Jammu & Kashmir,Criminal Trespass/Burglary_Total (Section 453 to 460 IPC),2014,857,1,858
Jammu & Kashmir,"Criminal Trespass/Burglary (Section 455, 457 & 458 IPC)",2014,322,0,322
Jammu & Kashmir,"House Trespass & House Breaking (Section 453,454,456,459 & 460 IPC)",2014,535,1,536
Jammu & Kashmir,Theft (Section 379 to 382 IPC),2014,1865,10,1875
Jammu & Kashmir,Auto Theft,2014,260,0,260
Jammu & Kashmir,Other Thefts,2014,1605,10,1615
Jammu & Kashmir,"Unlawful Assembly (Section 143,144 & 145)",2014,0,0,0
Jammu & Kashmir,"Riots (Section 147, 148, 149, 150 & 151 IPC)",2014,5022,486,5508
Jammu & Kashmir,Communal,2014,0,0,0
Jammu & Kashmir,Industrial,2014,0,0,0
Jammu & Kashmir,Political,2014,153,0,153
Jammu & Kashmir,Caste Conflict,2014,0,0,0
Jammu & Kashmir,SC/STs Vs. Non-SCs/STs,2014,0,0,0
Jammu & Kashmir,Other Caste Riots,2014,0,0,0
Jammu & Kashmir,Agrarian,2014,0,0,0
Jammu & Kashmir,Students,2014,0,0,0
Jammu & Kashmir,Sectarian,2014,0,0,0
Jammu & Kashmir,Other Riots,2014,4869,486,5355
Jammu & Kashmir,Criminal Breach of Trust (Section 406 to 409 IPC),2014,148,1,149
Jammu & Kashmir,Cheating (Section 420 IPC),2014,546,18,564
Jammu & Kashmir,"Forgery (Section 465, 468 & 471 IPC)",2014,15,1,16
Jammu & Kashmir,"Counterfeiting (Section 231-235,237-240, 242-243, 255 and 489-A to 489-E IPC)",2014,25,1,26
Jammu & Kashmir,"Offences related to Counterfeit Coin (Section 231-235,237, 238-240 & 242-243 IPC)",2014,0,0,0
Jammu & Kashmir,Counterfeiting Government Stamp (Section 255 IPC),2014,0,0,0
Jammu & Kashmir,Counterfeit currency & Bank notes (Section 489-A to 489-E IPC),2014,25,1,26
Jammu & Kashmir,Counterfeiting currency notes or Bank notes (Section 489A IPC),2014,10,0,10
Jammu & Kashmir,Using forged or counterfeit currency/Bank notes (Section 489B IPC),2014,14,1,15
Jammu & Kashmir,Possession of forged or counterfeiting currency / Bank notes (Section 489C IPC),2014,1,0,1
Jammu & Kashmir,Make/Possess materials for forging or counterfeiting currency/Bank notes (Section 489D IPC),2014,0,0,0
Jammu & Kashmir,Make/Use documents resembling currency notes/Bank notes (Section 489 E IPC),2014,0,0,0
Jammu & Kashmir,Arson (Section 435-436 & 438 IPC),2014,169,5,174
Jammu & Kashmir,"Grievous Hurt (Section 325,326,326A & 326 B IPC)",2014,656,49,705
Jammu & Kashmir,Grievous Hurt (Section 325 & 326 IPC),2014,656,49,705
Jammu & Kashmir,Acid attack (Section 326A IPC),2014,0,0,0
Jammu & Kashmir,Attempt to Acid Attack (Section 326B IPC),2014,0,0,0
Jammu & Kashmir,Dowry Deaths (Section 304-B IPC),2014,14,0,14
Jammu & Kashmir,Assault on women with intent to outrage her Modesty (Section 354 IPC),2014,2497,84,2581
Jammu & Kashmir,Sexual Harassment (Section 354A IPC),2014,346,13,359
Jammu & Kashmir,Assault on women with intent to Disrobe (Section 354B IPC),2014,254,0,254
Jammu & Kashmir,Voyeurism (Section 354C IPC),2014,0,0,0
Jammu & Kashmir,Stalking (Section 354D IPC),2014,1,0,1
Jammu & Kashmir,Others,2014,1896,71,1967
Jammu & Kashmir,Insult to the Modesty of Women (Section 509 IPC),2014,276,7,283
Jammu & Kashmir,At Office premises,2014,0,0,0
Jammu & Kashmir,Places related to work other than Office,2014,7,0,7
Jammu & Kashmir,In Public Transport system,2014,7,1,8
Jammu & Kashmir,In Other Places,2014,262,6,268
Jammu & Kashmir,Cruelty by Husband or his Relatives (Section 498-A IPC),2014,879,106,985
Jammu & Kashmir,Importation of Girls from Foreign Country (Section 366-B IPC),2014,0,0,0
Jammu & Kashmir,Causing Death by Negligence (Section 304-A IPC),2014,705,0,705
Jammu & Kashmir,Deaths due to negligent driving/act,2014,695,0,695
Jammu & Kashmir,Deaths due to Other Causes,2014,10,0,10
Jammu & Kashmir,"Offences against State (Section 121, 121A, 122, 123, 124-A IPC)",2014,0,0,0
Jammu & Kashmir,Sedition (Section 124A IPC),2014,0,0,0
Jammu & Kashmir,Other offences against State,2014,0,0,0
Jammu & Kashmir,Offences promoting enmity between different groups (Section 153A & 153B IPC),2014,0,0,0
Jammu & Kashmir,Promoting enmity on ground of religion race and place of Birth (Section 153A IPC),2014,0,0,0
Jammu & Kashmir,Imputation & assertions prejudicial to national integration (Section 153B IPC),2014,0,0,0
Jammu & Kashmir,Extortion (Section 384 - 389 IPC),2014,0,0,0
Jammu & Kashmir,Disclosure of Identity of Victims (Section 228 A IPC),2014,0,0,0
Jammu & Kashmir,Incidence of Rash Driving (Section 279 IPC Read with 337 & 338),2014,4700,1,4701
Jammu & Kashmir,Human Trafficking (Section 370 & 370A IPC),2014,0,0,0
Jammu & Kashmir,Unnatural Offences U/s 377 IPC,2014,27,0,27
Jammu & Kashmir,Other IPC crimes,2014,13585,1186,14771
Jammu & Kashmir,Total Cognizable IPC crimes,2014,34569,2043,36612
Jharkhand,Murder (Section 302 IPC),2014,2752,50,2802
Jharkhand,Attempt to commit Murder (Section 307 IPC),2014,1038,24,1062
Jharkhand,Culpable Homicide not amounting to Murder (Section 304 IPC),2014,152,1,153
Jharkhand,Attempt to commit Culpable Homicide (Section 308 IPC),2014,3,0,3
Jharkhand,Rape (Section 376 IPC),2014,1578,5,1583
Jharkhand,Custodial Rape,2014,0,0,0
Jharkhand,Gang Rape,2014,0,0,0
Jharkhand,Other Rape,2014,0,0,0
Jharkhand,Rape other than Custodial,2014,1578,5,1583
Jharkhand,Gang Rape,2014,77,0,77
Jharkhand,Other Rape,2014,1501,5,1506
Jharkhand,Attempt to commit Rape (Section 376/511 IPC),2014,177,1,178
Jharkhand,"Kidnapping & Abduction_Total (Section 3,364,364A, 366-369 IPC)",2014,1528,27,1555
Jharkhand,Kidnapping & Abduction (Section 363 IPC),2014,131,1,132
Jharkhand,Kidnaping & Abduction in order to Murder (Section 364 IPC),2014,73,0,73
Jharkhand,Kidnapping for Ransom (Section 364A IPC),2014,70,0,70
Jharkhand,Kidnapping & Abduction of Women to compel her for marriage (Section 366 IPC),2014,719,25,744
Jharkhand,Other Kidnapping,2014,535,1,536
Jharkhand,"Dacoity (Section 395,396-398 IPC)",2014,514,0,514
Jharkhand,Dacoity with Murder (Section 396 IPC),2014,4,0,4
Jharkhand,Other Dacoity,2014,510,0,510
Jharkhand,Making Preparation and Assembly for committing Dacoity (Section 399 & 402 IPC),2014,28,0,28
Jharkhand,"Robbery (Section 392 to 394, 397 and 398 IPC)",2014,987,0,987
Jharkhand,Criminal Trespass/Burglary_Total (Section 453 to 460 IPC),2014,878,3,881
Jharkhand,"Criminal Trespass/Burglary (Section 455, 457 & 458 IPC)",2014,587,3,590
Jharkhand,"House Trespass & House Breaking (Section 453,454,456,459 & 460 IPC)",2014,291,0,291
Jharkhand,Theft (Section 379 to 382 IPC),2014,4456,62,4518
Jharkhand,Auto Theft,2014,1262,0,1262
Jharkhand,Other Thefts,2014,3194,62,3256
Jharkhand,"Unlawful Assembly (Section 143,144 & 145)",2014,173,2,175
Jharkhand,"Riots (Section 147, 148, 149, 150 & 151 IPC)",2014,3428,264,3692
Jharkhand,Communal,2014,242,32,274
Jharkhand,Industrial,2014,0,0,0
Jharkhand,Political,2014,24,0,24
Jharkhand,Caste Conflict,2014,66,29,95
Jharkhand,SC/STs Vs. Non-SCs/STs,2014,2,0,2
Jharkhand,Other Caste Riots,2014,64,29,93
Jharkhand,Agrarian,2014,8,5,13
Jharkhand,Students,2014,0,0,0
Jharkhand,Sectarian,2014,0,0,0
Jharkhand,Other Riots,2014,3088,198,3286
Jharkhand,Criminal Breach of Trust (Section 406 to 409 IPC),2014,1042,10,1052
Jharkhand,Cheating (Section 420 IPC),2014,2824,22,2846
Jharkhand,"Forgery (Section 465, 468 & 471 IPC)",2014,298,2,300
Jharkhand,"Counterfeiting (Section 231-235,237-240, 242-243, 255 and 489-A to 489-E IPC)",2014,12,0,12
Jharkhand,"Offences related to Counterfeit Coin (Section 231-235,237, 238-240 & 242-243 IPC)",2014,0,0,0
Jharkhand,Counterfeiting Government Stamp (Section 255 IPC),2014,1,0,1
Jharkhand,Counterfeit currency & Bank notes (Section 489-A to 489-E IPC),2014,11,0,11
Jharkhand,Counterfeiting currency notes or Bank notes (Section 489A IPC),2014,7,0,7
Jharkhand,Using forged or counterfeit currency/Bank notes (Section 489B IPC),2014,0,0,0
Jharkhand,Possession of forged or counterfeiting currency / Bank notes (Section 489C IPC),2014,0,0,0
Jharkhand,Make/Possess materials for forging or counterfeiting currency/Bank notes (Section 489D IPC),2014,0,0,0
Jharkhand,Make/Use documents resembling currency notes/Bank notes (Section 489 E IPC),2014,4,0,4
Jharkhand,Arson (Section 435-436 & 438 IPC),2014,268,0,268
Jharkhand,"Grievous Hurt (Section 325,326,326A & 326 B IPC)",2014,2462,128,2590
Jharkhand,Grievous Hurt (Section 325 & 326 IPC),2014,2459,128,2587
Jharkhand,Acid attack (Section 326A IPC),2014,1,0,1
Jharkhand,Attempt to Acid Attack (Section 326B IPC),2014,2,0,2
Jharkhand,Dowry Deaths (Section 304-B IPC),2014,467,31,498
Jharkhand,Assault on women with intent to outrage her Modesty (Section 354 IPC),2014,603,0,603
Jharkhand,Sexual Harassment (Section 354A IPC),2014,234,0,234
Jharkhand,Assault on women with intent to Disrobe (Section 354B IPC),2014,84,0,84
Jharkhand,Voyeurism (Section 354C IPC),2014,0,0,0
Jharkhand,Stalking (Section 354D IPC),2014,4,0,4
Jharkhand,Others,2014,281,0,281
Jharkhand,Insult to the Modesty of Women (Section 509 IPC),2014,70,0,70
Jharkhand,At Office premises,2014,0,0,0
Jharkhand,Places related to work other than Office,2014,0,0,0
Jharkhand,In Public Transport system,2014,0,0,0
Jharkhand,In Other Places,2014,70,0,70
Jharkhand,Cruelty by Husband or his Relatives (Section 498-A IPC),2014,1537,218,1755
Jharkhand,Importation of Girls from Foreign Country (Section 366-B IPC),2014,2,0,2
Jharkhand,Causing Death by Negligence (Section 304-A IPC),2014,2615,0,2615
Jharkhand,Deaths due to negligent driving/act,2014,2545,0,2545
Jharkhand,Deaths due to Other Causes,2014,70,0,70
Jharkhand,"Offences against State (Section 121, 121A, 122, 123, 124-A IPC)",2014,18,0,18
Jharkhand,Sedition (Section 124A IPC),2014,18,0,18
Jharkhand,Other offences against State,2014,0,0,0
Jharkhand,Offences promoting enmity between different groups (Section 153A & 153B IPC),2014,0,0,0
Jharkhand,Promoting enmity on ground of religion race and place of Birth (Section 153A IPC),2014,0,0,0
Jharkhand,Imputation & assertions prejudicial to national integration (Section 153B IPC),2014,0,0,0
Jharkhand,Extortion (Section 384 - 389 IPC),2014,468,2,470
Jharkhand,Disclosure of Identity of Victims (Section 228 A IPC),2014,0,0,0
Jharkhand,Incidence of Rash Driving (Section 279 IPC Read with 337 & 338),2014,2228,5,2233
Jharkhand,Human Trafficking (Section 370 & 370A IPC),2014,108,8,116
Jharkhand,Unnatural Offences U/s 377 IPC,2014,12,0,12
Jharkhand,Other IPC crimes,2014,23613,1366,24979
Jharkhand,Total Cognizable IPC crimes,2014,56339,2231,58570
Karnataka,Murder (Section 302 IPC),2014,3110,330,3440
Karnataka,Attempt to commit Murder (Section 307 IPC),2014,5869,420,6289
Karnataka,Culpable Homicide not amounting to Murder (Section 304 IPC),2014,122,4,126
Karnataka,Attempt to commit Culpable Homicide (Section 308 IPC),2014,157,3,160
Karnataka,Rape (Section 376 IPC),2014,1888,62,1950
Karnataka,Custodial Rape,2014,0,0,0
Karnataka,Gang Rape,2014,0,0,0
Karnataka,Other Rape,2014,0,0,0
Karnataka,Rape other than Custodial,2014,1888,62,1950
Karnataka,Gang Rape,2014,75,0,75
Karnataka,Other Rape,2014,1813,62,1875
Karnataka,Attempt to commit Rape (Section 376/511 IPC),2014,27,0,27
Karnataka,"Kidnapping & Abduction_Total (Section 3,364,364A, 366-369 IPC)",2014,1920,45,1965
Karnataka,Kidnapping & Abduction (Section 363 IPC),2014,534,9,543
Karnataka,Kidnaping & Abduction in order to Murder (Section 364 IPC),2014,0,0,0
Karnataka,Kidnapping for Ransom (Section 364A IPC),2014,96,6,102
Karnataka,Kidnapping & Abduction of Women to compel her for marriage (Section 366 IPC),2014,400,9,409
Karnataka,Other Kidnapping,2014,890,21,911
Karnataka,"Dacoity (Section 395,396-398 IPC)",2014,877,12,889
Karnataka,Dacoity with Murder (Section 396 IPC),2014,0,0,0
Karnataka,Other Dacoity,2014,877,12,889
Karnataka,Making Preparation and Assembly for committing Dacoity (Section 399 & 402 IPC),2014,1932,1,1933
Karnataka,"Robbery (Section 392 to 394, 397 and 398 IPC)",2014,3082,36,3118
Karnataka,Criminal Trespass/Burglary_Total (Section 453 to 460 IPC),2014,6259,50,6309
Karnataka,"Criminal Trespass/Burglary (Section 455, 457 & 458 IPC)",2014,4535,37,4572
Karnataka,"House Trespass & House Breaking (Section 453,454,456,459 & 460 IPC)",2014,1724,13,1737
Karnataka,Theft (Section 379 to 382 IPC),2014,14299,246,14545
Karnataka,Auto Theft,2014,6005,8,6013
Karnataka,Other Thefts,2014,8294,238,8532
Karnataka,"Unlawful Assembly (Section 143,144 & 145)",2014,164,61,225
Karnataka,"Riots (Section 147, 148, 149, 150 & 151 IPC)",2014,23457,2254,25711
Karnataka,Communal,2014,351,0,351
Karnataka,Industrial,2014,66,0,66
Karnataka,Political,2014,228,0,228
Karnataka,Caste Conflict,2014,277,0,277
Karnataka,SC/STs Vs. Non-SCs/STs,2014,0,0,0
Karnataka,Other Caste Riots,2014,277,0,277
Karnataka,Agrarian,2014,233,23,256
Karnataka,Students,2014,15,0,15
Karnataka,Sectarian,2014,0,0,0
Karnataka,Other Riots,2014,22287,2231,24518
Karnataka,Criminal Breach of Trust (Section 406 to 409 IPC),2014,710,15,725
Karnataka,Cheating (Section 420 IPC),2014,7553,466,8019
Karnataka,"Forgery (Section 465, 468 & 471 IPC)",2014,299,10,309
Karnataka,"Counterfeiting (Section 231-235,237-240, 242-243, 255 and 489-A to 489-E IPC)",2014,93,1,94
Karnataka,"Offences related to Counterfeit Coin (Section 231-235,237, 238-240 & 242-243 IPC)",2014,0,0,0
Karnataka,Counterfeiting Government Stamp (Section 255 IPC),2014,1,0,1
Karnataka,Counterfeit currency & Bank notes (Section 489-A to 489-E IPC),2014,92,1,93
Karnataka,Counterfeiting currency notes or Bank notes (Section 489A IPC),2014,64,0,64
Karnataka,Using forged or counterfeit currency/Bank notes (Section 489B IPC),2014,17,1,18
Karnataka,Possession of forged or counterfeiting currency / Bank notes (Section 489C IPC),2014,10,0,10
Karnataka,Make/Possess materials for forging or counterfeiting currency/Bank notes (Section 489D IPC),2014,0,0,0
Karnataka,Make/Use documents resembling currency notes/Bank notes (Section 489 E IPC),2014,1,0,1
Karnataka,Arson (Section 435-436 & 438 IPC),2014,1401,15,1416
Karnataka,"Grievous Hurt (Section 325,326,326A & 326 B IPC)",2014,4245,304,4549
Karnataka,Grievous Hurt (Section 325 & 326 IPC),2014,4238,304,4542
Karnataka,Acid attack (Section 326A IPC),2014,5,0,5
Karnataka,Attempt to Acid Attack (Section 326B IPC),2014,2,0,2
Karnataka,Dowry Deaths (Section 304-B IPC),2014,480,195,675
Karnataka,Assault on women with intent to outrage her Modesty (Section 354 IPC),2014,7694,793,8487
Karnataka,Sexual Harassment (Section 354A IPC),2014,324,32,356
Karnataka,Assault on women with intent to Disrobe (Section 354B IPC),2014,230,42,272
Karnataka,Voyeurism (Section 354C IPC),2014,10,0,10
Karnataka,Stalking (Section 354D IPC),2014,71,1,72
Karnataka,Others,2014,7059,718,7777
Karnataka,Insult to the Modesty of Women (Section 509 IPC),2014,190,0,190
Karnataka,At Office premises,2014,5,0,5
Karnataka,Places related to work other than Office,2014,12,0,12
Karnataka,In Public Transport system,2014,2,0,2
Karnataka,In Other Places,2014,171,0,171
Karnataka,Cruelty by Husband or his Relatives (Section 498-A IPC),2014,4438,1085,5523
Karnataka,Importation of Girls from Foreign Country (Section 366-B IPC),2014,0,0,0
Karnataka,Causing Death by Negligence (Section 304-A IPC),2014,9858,39,9897
Karnataka,Deaths due to negligent driving/act,2014,9158,21,9179
Karnataka,Deaths due to Other Causes,2014,700,18,718
Karnataka,"Offences against State (Section 121, 121A, 122, 123, 124-A IPC)",2014,0,0,0
Karnataka,Sedition (Section 124A IPC),2014,0,0,0
Karnataka,Other offences against State,2014,0,0,0
Karnataka,Offences promoting enmity between different groups (Section 153A & 153B IPC),2014,62,1,63
Karnataka,Promoting enmity on ground of religion race and place of Birth (Section 153A IPC),2014,62,1,63
Karnataka,Imputation & assertions prejudicial to national integration (Section 153B IPC),2014,0,0,0
Karnataka,Extortion (Section 384 - 389 IPC),2014,202,16,218
Karnataka,Disclosure of Identity of Victims (Section 228 A IPC),2014,0,0,0
Karnataka,Incidence of Rash Driving (Section 279 IPC Read with 337 & 338),2014,33220,86,33306
Karnataka,Human Trafficking (Section 370 & 370A IPC),2014,186,6,192
Karnataka,Unnatural Offences U/s 377 IPC,2014,14,0,14
Karnataka,Other IPC crimes,2014,60695,4320,65015
Karnataka,Total Cognizable IPC crimes,2014,194503,10876,205379
Kerala,Murder (Section 302 IPC),2014,636,38,674
Kerala,Attempt to commit Murder (Section 307 IPC),2014,1670,25,1695
Kerala,Culpable Homicide not amounting to Murder (Section 304 IPC),2014,145,8,153
Kerala,Attempt to commit Culpable Homicide (Section 308 IPC),2014,2146,17,2163
Kerala,Rape (Section 376 IPC),2014,1417,25,1442
Kerala,Custodial Rape,2014,0,0,0
Kerala,Gang Rape,2014,0,0,0
Kerala,Other Rape,2014,0,0,0
Kerala,Rape other than Custodial,2014,1417,25,1442
Kerala,Gang Rape,2014,47,0,47
Kerala,Other Rape,2014,1370,25,1395
Kerala,Attempt to commit Rape (Section 376/511 IPC),2014,34,0,34
Kerala,"Kidnapping & Abduction_Total (Section 3,364,364A, 366-369 IPC)",2014,339,8,347
Kerala,Kidnapping & Abduction (Section 363 IPC),2014,49,1,50
Kerala,Kidnaping & Abduction in order to Murder (Section 364 IPC),2014,0,0,0
Kerala,Kidnapping for Ransom (Section 364A IPC),2014,21,0,21
Kerala,Kidnapping & Abduction of Women to compel her for marriage (Section 366 IPC),2014,106,1,107
Kerala,Other Kidnapping,2014,163,6,169
Kerala,"Dacoity (Section 395,396-398 IPC)",2014,231,11,242
Kerala,Dacoity with Murder (Section 396 IPC),2014,6,0,6
Kerala,Other Dacoity,2014,225,11,236
Kerala,Making Preparation and Assembly for committing Dacoity (Section 399 & 402 IPC),2014,310,0,310
Kerala,"Robbery (Section 392 to 394, 397 and 398 IPC)",2014,888,44,932
Kerala,Criminal Trespass/Burglary_Total (Section 453 to 460 IPC),2014,2585,55,2640
Kerala,"Criminal Trespass/Burglary (Section 455, 457 & 458 IPC)",2014,1927,22,1949
Kerala,"House Trespass & House Breaking (Section 453,454,456,459 & 460 IPC)",2014,658,33,691
Kerala,Theft (Section 379 to 382 IPC),2014,3729,269,3998
Kerala,Auto Theft,2014,1154,5,1159
Kerala,Other Thefts,2014,2575,264,2839
Kerala,"Unlawful Assembly (Section 143,144 & 145)",2014,5408,284,5692
Kerala,"Riots (Section 147, 148, 149, 150 & 151 IPC)",2014,26594,763,27357
Kerala,Communal,2014,582,0,582
Kerala,Industrial,2014,0,0,0
Kerala,Political,2014,3659,17,3676
Kerala,Caste Conflict,2014,0,0,0
Kerala,SC/STs Vs. Non-SCs/STs,2014,0,0,0
Kerala,Other Caste Riots,2014,0,0,0
Kerala,Agrarian,2014,0,0,0
Kerala,Students,2014,821,2,823
Kerala,Sectarian,2014,0,0,0
Kerala,Other Riots,2014,21532,744,22276
Kerala,Criminal Breach of Trust (Section 406 to 409 IPC),2014,423,17,440
Kerala,Cheating (Section 420 IPC),2014,6266,300,6566
Kerala,"Forgery (Section 465, 468 & 471 IPC)",2014,111,5,116
Kerala,"Counterfeiting (Section 231-235,237-240, 242-243, 255 and 489-A to 489-E IPC)",2014,62,1,63
Kerala,"Offences related to Counterfeit Coin (Section 231-235,237, 238-240 & 242-243 IPC)",2014,0,0,0
Kerala,Counterfeiting Government Stamp (Section 255 IPC),2014,0,0,0
Kerala,Counterfeit currency & Bank notes (Section 489-A to 489-E IPC),2014,62,1,63
Kerala,Counterfeiting currency notes or Bank notes (Section 489A IPC),2014,35,0,35
Kerala,Using forged or counterfeit currency/Bank notes (Section 489B IPC),2014,17,1,18
Kerala,Possession of forged or counterfeiting currency / Bank notes (Section 489C IPC),2014,8,0,8
Kerala,Make/Possess materials for forging or counterfeiting currency/Bank notes (Section 489D IPC),2014,0,0,0
Kerala,Make/Use documents resembling currency notes/Bank notes (Section 489 E IPC),2014,2,0,2
Kerala,Arson (Section 435-436 & 438 IPC),2014,539,0,539
Kerala,"Grievous Hurt (Section 325,326,326A & 326 B IPC)",2014,2343,33,2376
Kerala,Grievous Hurt (Section 325 & 326 IPC),2014,2340,32,2372
Kerala,Acid attack (Section 326A IPC),2014,3,1,4
Kerala,Attempt to Acid Attack (Section 326B IPC),2014,0,0,0
Kerala,Dowry Deaths (Section 304-B IPC),2014,42,14,56
Kerala,Assault on women with intent to outrage her Modesty (Section 354 IPC),2014,4663,65,4728
Kerala,Sexual Harassment (Section 354A IPC),2014,1073,1,1074
Kerala,Assault on women with intent to Disrobe (Section 354B IPC),2014,395,3,398
Kerala,Voyeurism (Section 354C IPC),2014,21,0,21
Kerala,Stalking (Section 354D IPC),2014,37,0,37
Kerala,Others,2014,3137,61,3198
Kerala,Insult to the Modesty of Women (Section 509 IPC),2014,298,1,299
Kerala,At Office premises,2014,6,0,6
Kerala,Places related to work other than Office,2014,3,0,3
Kerala,In Public Transport system,2014,12,0,12
Kerala,In Other Places,2014,277,1,278
Kerala,Cruelty by Husband or his Relatives (Section 498-A IPC),2014,5549,1269,6818
Kerala,Importation of Girls from Foreign Country (Section 366-B IPC),2014,0,0,0
Kerala,Causing Death by Negligence (Section 304-A IPC),2014,3486,11,3497
Kerala,Deaths due to negligent driving/act,2014,3407,9,3416
Kerala,Deaths due to Other Causes,2014,79,2,81
Kerala,"Offences against State (Section 121, 121A, 122, 123, 124-A IPC)",2014,8,0,8
Kerala,Sedition (Section 124A IPC),2014,4,0,4
Kerala,Other offences against State,2014,4,0,4
Kerala,Offences promoting enmity between different groups (Section 153A & 153B IPC),2014,89,1,90
Kerala,Promoting enmity on ground of religion race and place of Birth (Section 153A IPC),2014,84,1,85
Kerala,Imputation & assertions prejudicial to national integration (Section 153B IPC),2014,5,0,5
Kerala,Extortion (Section 384 - 389 IPC),2014,57,2,59
Kerala,Disclosure of Identity of Victims (Section 228 A IPC),2014,0,0,0
Kerala,Incidence of Rash Driving (Section 279 IPC Read with 337 & 338),2014,110757,263,111020
Kerala,Human Trafficking (Section 370 & 370A IPC),2014,13,3,16
Kerala,Unnatural Offences U/s 377 IPC,2014,129,9,138
Kerala,Other IPC crimes,2014,63391,1170,64561
Kerala,Total Cognizable IPC crimes,2014,244358,4711,249069
Madhya Pradesh,Murder (Section 302 IPC),2014,4321,316,4637
Madhya Pradesh,Attempt to commit Murder (Section 307 IPC),2014,6344,234,6578
Madhya Pradesh,Culpable Homicide not amounting to Murder (Section 304 IPC),2014,268,8,276
Madhya Pradesh,Attempt to commit Culpable Homicide (Section 308 IPC),2014,228,7,235
Madhya Pradesh,Rape (Section 376 IPC),2014,6518,201,6719
Madhya Pradesh,Custodial Rape,2014,0,0,0
Madhya Pradesh,Gang Rape,2014,0,0,0
Madhya Pradesh,Other Rape,2014,0,0,0
Madhya Pradesh,Rape other than Custodial,2014,6518,201,6719
Madhya Pradesh,Gang Rape,2014,668,18,686
Madhya Pradesh,Other Rape,2014,5850,183,6033
Madhya Pradesh,Attempt to commit Rape (Section 376/511 IPC),2014,63,0,63
Madhya Pradesh,"Kidnapping & Abduction_Total (Section 3,364,364A, 366-369 IPC)",2014,4225,126,4351
Madhya Pradesh,Kidnapping & Abduction (Section 363 IPC),2014,1383,20,1403
Madhya Pradesh,Kidnaping & Abduction in order to Murder (Section 364 IPC),2014,36,0,36
Madhya Pradesh,Kidnapping for Ransom (Section 364A IPC),2014,84,2,86
Madhya Pradesh,Kidnapping & Abduction of Women to compel her for marriage (Section 366 IPC),2014,1579,66,1645
Madhya Pradesh,Other Kidnapping,2014,1143,38,1181
Madhya Pradesh,"Dacoity (Section 395,396-398 IPC)",2014,813,1,814
Madhya Pradesh,Dacoity with Murder (Section 396 IPC),2014,5,0,5
Madhya Pradesh,Other Dacoity,2014,808,1,809
Madhya Pradesh,Making Preparation and Assembly for committing Dacoity (Section 399 & 402 IPC),2014,962,0,962
Madhya Pradesh,"Robbery (Section 392 to 394, 397 and 398 IPC)",2014,3152,26,3178
Madhya Pradesh,Criminal Trespass/Burglary_Total (Section 453 to 460 IPC),2014,7385,43,7428
Madhya Pradesh,"Criminal Trespass/Burglary (Section 455, 457 & 458 IPC)",2014,6120,31,6151
Madhya Pradesh,"House Trespass & House Breaking (Section 453,454,456,459 & 460 IPC)",2014,1265,12,1277
Madhya Pradesh,Theft (Section 379 to 382 IPC),2014,15053,138,15191
Madhya Pradesh,Auto Theft,2014,5040,1,5041
Madhya Pradesh,Other Thefts,2014,10013,137,10150
Madhya Pradesh,"Unlawful Assembly (Section 143,144 & 145)",2014,80,4,84
Madhya Pradesh,"Riots (Section 147, 148, 149, 150 & 151 IPC)",2014,12088,492,12580
Madhya Pradesh,Communal,2014,255,0,255
Madhya Pradesh,Industrial,2014,84,15,99
Madhya Pradesh,Political,2014,62,0,62
Madhya Pradesh,Caste Conflict,2014,1120,4,1124
Madhya Pradesh,SC/STs Vs. Non-SCs/STs,2014,57,4,61
Madhya Pradesh,Other Caste Riots,2014,1063,0,1063
Madhya Pradesh,Agrarian,2014,159,5,164
Madhya Pradesh,Students,2014,0,0,0
Madhya Pradesh,Sectarian,2014,0,0,0
Madhya Pradesh,Other Riots,2014,10408,468,10876
Madhya Pradesh,Criminal Breach of Trust (Section 406 to 409 IPC),2014,803,16,819
Madhya Pradesh,Cheating (Section 420 IPC),2014,2821,90,2911
Madhya Pradesh,"Forgery (Section 465, 468 & 471 IPC)",2014,284,10,294
Madhya Pradesh,"Counterfeiting (Section 231-235,237-240, 242-243, 255 and 489-A to 489-E IPC)",2014,63,2,65
Madhya Pradesh,"Offences related to Counterfeit Coin (Section 231-235,237, 238-240 & 242-243 IPC)",2014,0,0,0
Madhya Pradesh,Counterfeiting Government Stamp (Section 255 IPC),2014,0,0,0
Madhya Pradesh,Counterfeit currency & Bank notes (Section 489-A to 489-E IPC),2014,63,2,65
Madhya Pradesh,Counterfeiting currency notes or Bank notes (Section 489A IPC),2014,18,0,18
Madhya Pradesh,Using forged or counterfeit currency/Bank notes (Section 489B IPC),2014,32,0,32
Madhya Pradesh,Possession of forged or counterfeiting currency / Bank notes (Section 489C IPC),2014,3,0,3
Madhya Pradesh,Make/Possess materials for forging or counterfeiting currency/Bank notes (Section 489D IPC),2014,10,0,10
Madhya Pradesh,Make/Use documents resembling currency notes/Bank notes (Section 489 E IPC),2014,0,2,2
Madhya Pradesh,Arson (Section 435-436 & 438 IPC),2014,1310,34,1344
Madhya Pradesh,"Grievous Hurt (Section 325,326,326A & 326 B IPC)",2014,23153,1080,24233
Madhya Pradesh,Grievous Hurt (Section 325 & 326 IPC),2014,23132,1077,24209
Madhya Pradesh,Acid attack (Section 326A IPC),2014,17,3,20
Madhya Pradesh,Attempt to Acid Attack (Section 326B IPC),2014,4,0,4
Madhya Pradesh,Dowry Deaths (Section 304-B IPC),2014,1451,566,2017
Madhya Pradesh,Assault on women with intent to outrage her Modesty (Section 354 IPC),2014,12093,56,12149
Madhya Pradesh,Sexual Harassment (Section 354A IPC),2014,4362,13,4375
Madhya Pradesh,Assault on women with intent to Disrobe (Section 354B IPC),2014,174,2,176
Madhya Pradesh,Voyeurism (Section 354C IPC),2014,103,0,103
Madhya Pradesh,Stalking (Section 354D IPC),2014,481,1,482
Madhya Pradesh,Others,2014,6973,40,7013
Madhya Pradesh,Insult to the Modesty of Women (Section 509 IPC),2014,623,3,626
Madhya Pradesh,At Office premises,2014,1,0,1
Madhya Pradesh,Places related to work other than Office,2014,50,0,50
Madhya Pradesh,In Public Transport system,2014,3,0,3
Madhya Pradesh,In Other Places,2014,569,3,572
Madhya Pradesh,Cruelty by Husband or his Relatives (Section 498-A IPC),2014,12126,3734,15860
Madhya Pradesh,Importation of Girls from Foreign Country (Section 366-B IPC),2014,8,0,8
Madhya Pradesh,Causing Death by Negligence (Section 304-A IPC),2014,7757,5,7762
Madhya Pradesh,Deaths due to negligent driving/act,2014,7007,4,7011
Madhya Pradesh,Deaths due to Other Causes,2014,750,1,751
Madhya Pradesh,"Offences against State (Section 121, 121A, 122, 123, 124-A IPC)",2014,0,0,0
Madhya Pradesh,Sedition (Section 124A IPC),2014,0,0,0
Madhya Pradesh,Other offences against State,2014,0,0,0
Madhya Pradesh,Offences promoting enmity between different groups (Section 153A & 153B IPC),2014,10,0,10
Madhya Pradesh,Promoting enmity on ground of religion race and place of Birth (Section 153A IPC),2014,6,0,6
Madhya Pradesh,Imputation & assertions prejudicial to national integration (Section 153B IPC),2014,4,0,4
Madhya Pradesh,Extortion (Section 384 - 389 IPC),2014,152,0,152
Madhya Pradesh,Disclosure of Identity of Victims (Section 228 A IPC),2014,0,0,0
Madhya Pradesh,Incidence of Rash Driving (Section 279 IPC Read with 337 & 338),2014,35084,117,35201
Madhya Pradesh,Human Trafficking (Section 370 & 370A IPC),2014,113,21,134
Madhya Pradesh,Unnatural Offences U/s 377 IPC,2014,139,0,139
Madhya Pradesh,Other IPC crimes,2014,219464,13098,232562
Madhya Pradesh,Total Cognizable IPC crimes,2014,378954,20428,399382
Maharashtra,Murder (Section 302 IPC),2014,5187,579,5766
Maharashtra,Attempt to commit Murder (Section 307 IPC),2014,8024,614,8638
Maharashtra,Culpable Homicide not amounting to Murder (Section 304 IPC),2014,276,21,297
Maharashtra,Attempt to commit Culpable Homicide (Section 308 IPC),2014,23,11,34
Maharashtra,Rape (Section 376 IPC),2014,4321,246,4567
Maharashtra,Custodial Rape,2014,0,0,0
Maharashtra,Gang Rape,2014,0,0,0
Maharashtra,Other Rape,2014,0,0,0
Maharashtra,Rape other than Custodial,2014,4321,246,4567
Maharashtra,Gang Rape,2014,356,6,362
Maharashtra,Other Rape,2014,3965,240,4205
Maharashtra,Attempt to commit Rape (Section 376/511 IPC),2014,17,2,19
Maharashtra,"Kidnapping & Abduction_Total (Section 3,364,364A, 366-369 IPC)",2014,3007,318,3325
Maharashtra,Kidnapping & Abduction (Section 363 IPC),2014,1130,120,1250
Maharashtra,Kidnaping & Abduction in order to Murder (Section 364 IPC),2014,27,3,30
Maharashtra,Kidnapping for Ransom (Section 364A IPC),2014,70,1,71
Maharashtra,Kidnapping & Abduction of Women to compel her for marriage (Section 366 IPC),2014,1052,136,1188
Maharashtra,Other Kidnapping,2014,728,58,786
Maharashtra,"Dacoity (Section 395,396-398 IPC)",2014,4270,136,4406
Maharashtra,Dacoity with Murder (Section 396 IPC),2014,59,4,63
Maharashtra,Other Dacoity,2014,4211,132,4343
Maharashtra,Making Preparation and Assembly for committing Dacoity (Section 399 & 402 IPC),2014,1430,8,1438
Maharashtra,"Robbery (Section 392 to 394, 397 and 398 IPC)",2014,9903,218,10121
Maharashtra,Criminal Trespass/Burglary_Total (Section 453 to 460 IPC),2014,11292,359,11651
Maharashtra,"Criminal Trespass/Burglary (Section 455, 457 & 458 IPC)",2014,8212,251,8463
Maharashtra,"House Trespass & House Breaking (Section 453,454,456,459 & 460 IPC)",2014,3080,108,3188
Maharashtra,Theft (Section 379 to 382 IPC),2014,31207,1394,32601
Maharashtra,Auto Theft,2014,7712,40,7752
Maharashtra,Other Thefts,2014,23495,1354,24849
Maharashtra,"Unlawful Assembly (Section 143,144 & 145)",2014,6943,919,7862
Maharashtra,"Riots (Section 147, 148, 149, 150 & 151 IPC)",2014,43237,4653,47890
Maharashtra,Communal,2014,850,11,861
Maharashtra,Industrial,2014,32,0,32
Maharashtra,Political,2014,981,85,1066
Maharashtra,Caste Conflict,2014,2274,141,2415
Maharashtra,SC/STs Vs. Non-SCs/STs,2014,858,44,902
Maharashtra,Other Caste Riots,2014,1416,97,1513
Maharashtra,Agrarian,2014,430,42,472
Maharashtra,Students,2014,37,0,37
Maharashtra,Sectarian,2014,0,0,0
Maharashtra,Other Riots,2014,38633,4374,43007
Maharashtra,Criminal Breach of Trust (Section 406 to 409 IPC),2014,2379,105,2484
Maharashtra,Cheating (Section 420 IPC),2014,9934,715,10649
Maharashtra,"Forgery (Section 465, 468 & 471 IPC)",2014,1124,69,1193
Maharashtra,"Counterfeiting (Section 231-235,237-240, 242-243, 255 and 489-A to 489-E IPC)",2014,215,12,227
Maharashtra,"Offences related to Counterfeit Coin (Section 231-235,237, 238-240 & 242-243 IPC)",2014,0,0,0
Maharashtra,Counterfeiting Government Stamp (Section 255 IPC),2014,0,0,0
Maharashtra,Counterfeit currency & Bank notes (Section 489-A to 489-E IPC),2014,215,12,227
Maharashtra,Counterfeiting currency notes or Bank notes (Section 489A IPC),2014,132,7,139
Maharashtra,Using forged or counterfeit currency/Bank notes (Section 489B IPC),2014,61,4,65
Maharashtra,Possession of forged or counterfeiting currency / Bank notes (Section 489C IPC),2014,22,1,23
Maharashtra,Make/Possess materials for forging or counterfeiting currency/Bank notes (Section 489D IPC),2014,0,0,0
Maharashtra,Make/Use documents resembling currency notes/Bank notes (Section 489 E IPC),2014,0,0,0
Maharashtra,Arson (Section 435-436 & 438 IPC),2014,1207,42,1249
Maharashtra,"Grievous Hurt (Section 325,326,326A & 326 B IPC)",2014,15633,1407,17040
Maharashtra,Grievous Hurt (Section 325 & 326 IPC),2014,15629,1407,17036
Maharashtra,Acid attack (Section 326A IPC),2014,4,0,4
Maharashtra,Attempt to Acid Attack (Section 326B IPC),2014,0,0,0
Maharashtra,Dowry Deaths (Section 304-B IPC),2014,646,303,949
Maharashtra,Assault on women with intent to outrage her Modesty (Section 354 IPC),2014,12077,461,12538
Maharashtra,Sexual Harassment (Section 354A IPC),2014,4657,154,4811
Maharashtra,Assault on women with intent to Disrobe (Section 354B IPC),2014,420,21,441
Maharashtra,Voyeurism (Section 354C IPC),2014,105,4,109
Maharashtra,Stalking (Section 354D IPC),2014,862,11,873
Maharashtra,Others,2014,6033,271,6304
Maharashtra,Insult to the Modesty of Women (Section 509 IPC),2014,1816,106,1922
Maharashtra,At Office premises,2014,12,0,12
Maharashtra,Places related to work other than Office,2014,45,2,47
Maharashtra,In Public Transport system,2014,10,0,10
Maharashtra,In Other Places,2014,1749,104,1853
Maharashtra,Cruelty by Husband or his Relatives (Section 498-A IPC),2014,15802,8939,24741
Maharashtra,Importation of Girls from Foreign Country (Section 366-B IPC),2014,2,0,2
Maharashtra,Causing Death by Negligence (Section 304-A IPC),2014,9665,33,9698
Maharashtra,Deaths due to negligent driving/act,2014,8968,20,8988
Maharashtra,Deaths due to Other Causes,2014,697,13,710
Maharashtra,"Offences against State (Section 121, 121A, 122, 123, 124-A IPC)",2014,0,0,0
Maharashtra,Sedition (Section 124A IPC),2014,0,0,0
Maharashtra,Other offences against State,2014,0,0,0
Maharashtra,Offences promoting enmity between different groups (Section 153A & 153B IPC),2014,203,1,204
Maharashtra,Promoting enmity on ground of religion race and place of Birth (Section 153A IPC),2014,202,1,203
Maharashtra,Imputation & assertions prejudicial to national integration (Section 153B IPC),2014,1,0,1
Maharashtra,Extortion (Section 384 - 389 IPC),2014,1113,39,1152
Maharashtra,Disclosure of Identity of Victims (Section 228 A IPC),2014,0,0,0
Maharashtra,Incidence of Rash Driving (Section 279 IPC Read with 337 & 338),2014,23893,183,24076
Maharashtra,Human Trafficking (Section 370 & 370A IPC),2014,228,75,303
Maharashtra,Unnatural Offences U/s 377 IPC,2014,98,0,98
Maharashtra,Other IPC crimes,2014,82568,8600,91168
Maharashtra,Total Cognizable IPC crimes,2014,307740,30568,338308
Manipur,Murder (Section 302 IPC),2014,50,5,55
Manipur,Attempt to commit Murder (Section 307 IPC),2014,115,12,127
Manipur,Culpable Homicide not amounting to Murder (Section 304 IPC),2014,1,0,1
Manipur,Attempt to commit Culpable Homicide (Section 308 IPC),2014,0,0,0
Manipur,Rape (Section 376 IPC),2014,65,10,75
Manipur,Custodial Rape,2014,0,0,0
Manipur,Gang Rape,2014,0,0,0
Manipur,Other Rape,2014,0,0,0
Manipur,Rape other than Custodial,2014,65,10,75
Manipur,Other Rape,2014,65,10,75
Manipur,Attempt to commit Rape (Section 376/511 IPC),2014,0,0,0
Manipur,"Kidnapping & Abduction_Total (Section 3,364,364A, 366-369 IPC)",2014,87,10,97
Manipur,Kidnapping & Abduction (Section 363 IPC),2014,1,0,1
Manipur,Kidnaping & Abduction in order to Murder (Section 364 IPC),2014,0,0,0
Manipur,Kidnapping for Ransom (Section 364A IPC),2014,10,1,11
Manipur,Kidnapping & Abduction of Women to compel her for marriage (Section 366 IPC),2014,62,8,70
Manipur,Other Kidnapping,2014,14,1,15
Manipur,"Dacoity (Section 395,396-398 IPC)",2014,0,0,0
Manipur,Dacoity with Murder (Section 396 IPC),2014,0,0,0
Manipur,Other Dacoity,2014,0,0,0
Manipur,Making Preparation and Assembly for committing Dacoity (Section 399 & 402 IPC),2014,0,0,0
Manipur,"Robbery (Section 392 to 394, 397 and 398 IPC)",2014,7,0,7
Manipur,Criminal Trespass/Burglary_Total (Section 453 to 460 IPC),2014,25,0,25
Manipur,"Criminal Trespass/Burglary (Section 455, 457 & 458 IPC)",2014,18,0,18
Manipur,"House Trespass & House Breaking (Section 453,454,456,459 & 460 IPC)",2014,7,0,7
Manipur,Theft (Section 379 to 382 IPC),2014,235,6,241
Manipur,Auto Theft,2014,165,2,167
Manipur,Other Thefts,2014,70,4,74
Manipur,"Unlawful Assembly (Section 143,144 & 145)",2014,0,0,0
Manipur,"Riots (Section 147, 148, 149, 150 & 151 IPC)",2014,64,42,106
Manipur,Communal,2014,2,0,2
Manipur,Industrial,2014,0,0,0
Manipur,Political,2014,0,0,0
Manipur,Caste Conflict,2014,0,0,0
Manipur,SC/STs Vs. Non-SCs/STs,2014,0,0,0
Manipur,Other Caste Riots,2014,0,0,0
Manipur,Agrarian,2014,0,0,0
Manipur,Students,2014,5,2,7
Manipur,Sectarian,2014,0,0,0
Manipur,Other Riots,2014,57,40,97
Manipur,Criminal Breach of Trust (Section 406 to 409 IPC),2014,14,2,16
Manipur,Cheating (Section 420 IPC),2014,37,6,43
Manipur,"Forgery (Section 465, 468 & 471 IPC)",2014,21,0,21
Manipur,"Counterfeiting (Section 231-235,237-240, 242-243, 255 and 489-A to 489-E IPC)",2014,5,0,5
Manipur,"Offences related to Counterfeit Coin (Section 231-235,237, 238-240 & 242-243 IPC)",2014,0,0,0
Manipur,Counterfeiting Government Stamp (Section 255 IPC),2014,0,0,0
Manipur,Counterfeit currency & Bank notes (Section 489-A to 489-E IPC),2014,5,0,5
Manipur,Counterfeiting currency notes or Bank notes (Section 489A IPC),2014,0,0,0
Manipur,Using forged or counterfeit currency/Bank notes (Section 489B IPC),2014,2,0,2
Manipur,Possession of forged or counterfeiting currency / Bank notes (Section 489C IPC),2014,3,0,3
Manipur,Make/Possess materials for forging or counterfeiting currency/Bank notes (Section 489D IPC),2014,0,0,0
Manipur,Make/Use documents resembling currency notes/Bank notes (Section 489 E IPC),2014,0,0,0
Manipur,Arson (Section 435-436 & 438 IPC),2014,12,0,12
Manipur,"Grievous Hurt (Section 325,326,326A & 326 B IPC)",2014,123,11,134
Manipur,Grievous Hurt (Section 325 & 326 IPC),2014,123,11,134
Manipur,Acid attack (Section 326A IPC),2014,0,0,0
Manipur,Attempt to Acid Attack (Section 326B IPC),2014,0,0,0
Manipur,Dowry Deaths (Section 304-B IPC),2014,1,0,1
Manipur,Assault on women with intent to outrage her Modesty (Section 354 IPC),2014,44,3,47
Manipur,Sexual Harassment (Section 354A IPC),2014,3,0,3
Manipur,Assault on women with intent to Disrobe (Section 354B IPC),2014,0,0,0
Manipur,Voyeurism (Section 354C IPC),2014,0,0,0
Manipur,Stalking (Section 354D IPC),2014,0,0,0
Manipur,Others,2014,41,3,44
Manipur,Insult to the Modesty of Women (Section 509 IPC),2014,0,0,0
Manipur,At Office premises,2014,0,0,0
Manipur,Places related to work other than Office,2014,0,0,0
Manipur,In Public Transport system,2014,0,0,0
Manipur,In Other Places,2014,0,0,0
Manipur,Cruelty by Husband or his Relatives (Section 498-A IPC),2014,17,1,18
Manipur,Importation of Girls from Foreign Country (Section 366-B IPC),2014,0,0,0
Manipur,Causing Death by Negligence (Section 304-A IPC),2014,83,2,85
Manipur,Deaths due to negligent driving/act,2014,82,2,84
Manipur,Deaths due to Other Causes,2014,1,0,1
Manipur,"Offences against State (Section 121, 121A, 122, 123, 124-A IPC)",2014,8,0,8
Manipur,Sedition (Section 124A IPC),2014,0,0,0
Manipur,Other offences against State,2014,8,0,8
Manipur,Offences promoting enmity between different groups (Section 153A & 153B IPC),2014,0,0,0
Manipur,Promoting enmity on ground of religion race and place of Birth (Section 153A IPC),2014,0,0,0
Manipur,Imputation & assertions prejudicial to national integration (Section 153B IPC),2014,0,0,0
Manipur,Extortion (Section 384 - 389 IPC),2014,49,1,50
Manipur,Disclosure of Identity of Victims (Section 228 A IPC),2014,0,0,0
Manipur,Incidence of Rash Driving (Section 279 IPC Read with 337 & 338),2014,180,1,181
Manipur,Human Trafficking (Section 370 & 370A IPC),2014,1,0,1
Manipur,Unnatural Offences U/s 377 IPC,2014,0,0,0
Manipur,Other IPC crimes,2014,362,26,388
Manipur,Total Cognizable IPC crimes,2014,1606,138,1744
Meghalaya,Murder (Section 302 IPC),2014,193,3,196
Meghalaya,Attempt to commit Murder (Section 307 IPC),2014,106,2,108
Meghalaya,Culpable Homicide not amounting to Murder (Section 304 IPC),2014,11,0,11
Meghalaya,Attempt to commit Culpable Homicide (Section 308 IPC),2014,0,0,0
Meghalaya,Rape (Section 376 IPC),2014,161,1,162
Meghalaya,Custodial Rape,2014,0,0,0
Meghalaya,Gang Rape,2014,0,0,0
Meghalaya,Other Rape,2014,0,0,0
Meghalaya,Rape other than Custodial,2014,161,1,162
Meghalaya,Gang Rape,2014,6,0,6
Meghalaya,Other Rape,2014,155,1,156
Meghalaya,Attempt to commit Rape (Section 376/511 IPC),2014,20,0,20
Meghalaya,"Kidnapping & Abduction_Total (Section 3,364,364A, 366-369 IPC)",2014,164,8,172
Meghalaya,Kidnapping & Abduction (Section 363 IPC),2014,27,2,29
Meghalaya,Kidnaping & Abduction in order to Murder (Section 364 IPC),2014,1,0,1
Meghalaya,Kidnapping for Ransom (Section 364A IPC),2014,35,2,37
Meghalaya,Kidnapping & Abduction of Women to compel her for marriage (Section 366 IPC),2014,4,1,5
Meghalaya,Other Kidnapping,2014,97,3,100
Meghalaya,"Dacoity (Section 395,396-398 IPC)",2014,72,0,72
Meghalaya,Dacoity with Murder (Section 396 IPC),2014,0,0,0
Meghalaya,Other Dacoity,2014,72,0,72
Meghalaya,Making Preparation and Assembly for committing Dacoity (Section 399 & 402 IPC),2014,0,0,0
Meghalaya,"Robbery (Section 392 to 394, 397 and 398 IPC)",2014,96,0,96
Meghalaya,Criminal Trespass/Burglary_Total (Section 453 to 460 IPC),2014,91,0,91
Meghalaya,"Criminal Trespass/Burglary (Section 455, 457 & 458 IPC)",2014,53,0,53
Meghalaya,"House Trespass & House Breaking (Section 453,454,456,459 & 460 IPC)",2014,38,0,38
Meghalaya,Theft (Section 379 to 382 IPC),2014,603,6,609
Meghalaya,Auto Theft,2014,99,4,103
Meghalaya,Other Thefts,2014,504,2,506
Meghalaya,"Unlawful Assembly (Section 143,144 & 145)",2014,0,0,0
Meghalaya,"Riots (Section 147, 148, 149, 150 & 151 IPC)",2014,4,0,4
Meghalaya,Communal,2014,0,0,0
Meghalaya,Industrial,2014,0,0,0
Meghalaya,Political,2014,0,0,0
Meghalaya,Caste Conflict,2014,0,0,0
Meghalaya,SC/STs Vs. Non-SCs/STs,2014,0,0,0
Meghalaya,Other Caste Riots,2014,0,0,0
Meghalaya,Agrarian,2014,0,0,0
Meghalaya,Students,2014,0,0,0
Meghalaya,Sectarian,2014,0,0,0
Meghalaya,Other Riots,2014,4,0,4
Meghalaya,Criminal Breach of Trust (Section 406 to 409 IPC),2014,34,1,35
Meghalaya,Cheating (Section 420 IPC),2014,102,8,110
Meghalaya,"Forgery (Section 465, 468 & 471 IPC)",2014,25,0,25
Meghalaya,"Counterfeiting (Section 231-235,237-240, 242-243, 255 and 489-A to 489-E IPC)",2014,14,0,14
Meghalaya,"Offences related to Counterfeit Coin (Section 231-235,237, 238-240 & 242-243 IPC)",2014,0,0,0
Meghalaya,Counterfeiting Government Stamp (Section 255 IPC),2014,0,0,0
Meghalaya,Counterfeit currency & Bank notes (Section 489-A to 489-E IPC),2014,14,0,14
Meghalaya,Counterfeiting currency notes or Bank notes (Section 489A IPC),2014,0,0,0
Meghalaya,Using forged or counterfeit currency/Bank notes (Section 489B IPC),2014,7,0,7
Meghalaya,Possession of forged or counterfeiting currency / Bank notes (Section 489C IPC),2014,7,0,7
Meghalaya,Make/Possess materials for forging or counterfeiting currency/Bank notes (Section 489D IPC),2014,0,0,0
Meghalaya,Make/Use documents resembling currency notes/Bank notes (Section 489 E IPC),2014,0,0,0
Meghalaya,Arson (Section 435-436 & 438 IPC),2014,35,0,35
Meghalaya,"Grievous Hurt (Section 325,326,326A & 326 B IPC)",2014,242,2,244
Meghalaya,Grievous Hurt (Section 325 & 326 IPC),2014,242,2,244
Meghalaya,Acid attack (Section 326A IPC),2014,0,0,0
Meghalaya,Attempt to Acid Attack (Section 326B IPC),2014,0,0,0
Meghalaya,Dowry Deaths (Section 304-B IPC),2014,1,0,1
Meghalaya,Assault on women with intent to outrage her Modesty (Section 354 IPC),2014,99,0,99
Meghalaya,Sexual Harassment (Section 354A IPC),2014,0,0,0
Meghalaya,Assault on women with intent to Disrobe (Section 354B IPC),2014,10,0,10
Meghalaya,Voyeurism (Section 354C IPC),2014,1,0,1
Meghalaya,Stalking (Section 354D IPC),2014,4,0,4
Meghalaya,Others,2014,84,0,84
Meghalaya,Insult to the Modesty of Women (Section 509 IPC),2014,37,0,37
Meghalaya,At Office premises,2014,0,0,0
Meghalaya,Places related to work other than Office,2014,0,0,0
Meghalaya,In Public Transport system,2014,0,0,0
Meghalaya,In Other Places,2014,37,0,37
Meghalaya,Cruelty by Husband or his Relatives (Section 498-A IPC),2014,29,2,31
Meghalaya,Importation of Girls from Foreign Country (Section 366-B IPC),2014,0,0,0
Meghalaya,Causing Death by Negligence (Section 304-A IPC),2014,136,0,136
Meghalaya,Deaths due to negligent driving/act,2014,119,0,119
Meghalaya,Deaths due to Other Causes,2014,17,0,17
Meghalaya,"Offences against State (Section 121, 121A, 122, 123, 124-A IPC)",2014,66,1,67
Meghalaya,Sedition (Section 124A IPC),2014,0,0,0
Meghalaya,Other offences against State,2014,66,1,67
Meghalaya,Offences promoting enmity between different groups (Section 153A & 153B IPC),2014,0,0,0
Meghalaya,Promoting enmity on ground of religion race and place of Birth (Section 153A IPC),2014,0,0,0
Meghalaya,Imputation & assertions prejudicial to national integration (Section 153B IPC),2014,0,0,0
Meghalaya,Extortion (Section 384 - 389 IPC),2014,135,3,138
Meghalaya,Disclosure of Identity of Victims (Section 228 A IPC),2014,0,0,0
Meghalaya,Incidence of Rash Driving (Section 279 IPC Read with 337 & 338),2014,75,1,76
Meghalaya,Human Trafficking (Section 370 & 370A IPC),2014,0,0,0
Meghalaya,Unnatural Offences U/s 377 IPC,2014,0,0,0
Meghalaya,Other IPC crimes,2014,713,14,727
Meghalaya,Total Cognizable IPC crimes,2014,3264,52,3316
Mizoram,Murder (Section 302 IPC),2014,52,1,53
Mizoram,Attempt to commit Murder (Section 307 IPC),2014,33,0,33
Mizoram,Culpable Homicide not amounting to Murder (Section 304 IPC),2014,10,1,11
Mizoram,Attempt to commit Culpable Homicide (Section 308 IPC),2014,1,0,1
Mizoram,Rape (Section 376 IPC),2014,143,0,143
Mizoram,Custodial Rape,2014,0,0,0
Mizoram,Gang Rape,2014,0,0,0
Mizoram,Other Rape,2014,0,0,0
Mizoram,Rape other than Custodial,2014,143,0,143
Mizoram,Gang Rape,2014,22,0,22
Mizoram,Other Rape,2014,121,0,121
Mizoram,Attempt to commit Rape (Section 376/511 IPC),2014,1,0,1
Mizoram,"Kidnapping & Abduction_Total (Section 3,364,364A, 366-369 IPC)",2014,8,2,10
Mizoram,Kidnapping & Abduction (Section 363 IPC),2014,7,1,8
Mizoram,Kidnaping & Abduction in order to Murder (Section 364 IPC),2014,0,0,0
Mizoram,Kidnapping for Ransom (Section 364A IPC),2014,1,0,1
Mizoram,Kidnapping & Abduction of Women to compel her for marriage (Section 366 IPC),2014,0,0,0
Mizoram,Other Kidnapping,2014,0,1,1
Mizoram,"Dacoity (Section 395,396-398 IPC)",2014,4,0,4
Mizoram,Dacoity with Murder (Section 396 IPC),2014,0,0,0
Mizoram,Other Dacoity,2014,4,0,4
Mizoram,Making Preparation and Assembly for committing Dacoity (Section 399 & 402 IPC),2014,0,0,0
Mizoram,"Robbery (Section 392 to 394, 397 and 398 IPC)",2014,7,0,7
Mizoram,Criminal Trespass/Burglary_Total (Section 453 to 460 IPC),2014,502,3,505
Mizoram,"Criminal Trespass/Burglary (Section 455, 457 & 458 IPC)",2014,300,0,300
Mizoram,"House Trespass & House Breaking (Section 453,454,456,459 & 460 IPC)",2014,202,3,205
Mizoram,Theft (Section 379 to 382 IPC),2014,873,13,886
Mizoram,Auto Theft,2014,96,0,96
Mizoram,Other Thefts,2014,777,13,790
Mizoram,"Unlawful Assembly (Section 143,144 & 145)",2014,0,0,0
Mizoram,"Riots (Section 147, 148, 149, 150 & 151 IPC)",2014,0,0,0
Mizoram,Communal,2014,0,0,0
Mizoram,Industrial,2014,0,0,0
Mizoram,Political,2014,0,0,0
Mizoram,Caste Conflict,2014,0,0,0
Mizoram,SC/STs Vs. Non-SCs/STs,2014,0,0,0
Mizoram,Other Caste Riots,2014,0,0,0
Mizoram,Agrarian,2014,0,0,0
Mizoram,Students,2014,0,0,0
Mizoram,Sectarian,2014,0,0,0
Mizoram,Other Riots,2014,0,0,0
Mizoram,Criminal Breach of Trust (Section 406 to 409 IPC),2014,21,1,22
Mizoram,Cheating (Section 420 IPC),2014,66,12,78
Mizoram,"Forgery (Section 465, 468 & 471 IPC)",2014,5,1,6
Mizoram,"Counterfeiting (Section 231-235,237-240, 242-243, 255 and 489-A to 489-E IPC)",2014,9,2,11
Mizoram,"Offences related to Counterfeit Coin (Section 231-235,237, 238-240 & 242-243 IPC)",2014,0,0,0
Mizoram,Counterfeiting Government Stamp (Section 255 IPC),2014,0,0,0
Mizoram,Counterfeit currency & Bank notes (Section 489-A to 489-E IPC),2014,9,2,11
Mizoram,Counterfeiting currency notes or Bank notes (Section 489A IPC),2014,4,0,4
Mizoram,Using forged or counterfeit currency/Bank notes (Section 489B IPC),2014,0,0,0
Mizoram,Possession of forged or counterfeiting currency / Bank notes (Section 489C IPC),2014,5,2,7
Mizoram,Make/Possess materials for forging or counterfeiting currency/Bank notes (Section 489D IPC),2014,0,0,0
Mizoram,Make/Use documents resembling currency notes/Bank notes (Section 489 E IPC),2014,0,0,0
Mizoram,Arson (Section 435-436 & 438 IPC),2014,32,2,34
Mizoram,"Grievous Hurt (Section 325,326,326A & 326 B IPC)",2014,121,6,127
Mizoram,Grievous Hurt (Section 325 & 326 IPC),2014,121,6,127
Mizoram,Acid attack (Section 326A IPC),2014,0,0,0
Mizoram,Attempt to Acid Attack (Section 326B IPC),2014,0,0,0
Mizoram,Dowry Deaths (Section 304-B IPC),2014,0,0,0
Mizoram,Assault on women with intent to outrage her Modesty (Section 354 IPC),2014,102,0,102
Mizoram,Sexual Harassment (Section 354A IPC),2014,54,0,54
Mizoram,Assault on women with intent to Disrobe (Section 354B IPC),2014,18,0,18
Mizoram,Voyeurism (Section 354C IPC),2014,2,0,2
Mizoram,Stalking (Section 354D IPC),2014,6,0,6
Mizoram,Others,2014,22,0,22
Mizoram,Insult to the Modesty of Women (Section 509 IPC),2014,8,0,8
Mizoram,At Office premises,2014,0,0,0
Mizoram,Places related to work other than Office,2014,8,0,8
Mizoram,In Public Transport system,2014,0,0,0
Mizoram,In Other Places,2014,0,0,0
Mizoram,Cruelty by Husband or his Relatives (Section 498-A IPC),2014,11,0,11
Mizoram,Importation of Girls from Foreign Country (Section 366-B IPC),2014,0,0,0
Mizoram,Causing Death by Negligence (Section 304-A IPC),2014,71,1,72
Mizoram,Deaths due to negligent driving/act,2014,65,1,66
Mizoram,Deaths due to Other Causes,2014,6,0,6
Mizoram,"Offences against State (Section 121, 121A, 122, 123, 124-A IPC)",2014,1,0,1
Mizoram,Sedition (Section 124A IPC),2014,0,0,0
Mizoram,Other offences against State,2014,1,0,1
Mizoram,Offences promoting enmity between different groups (Section 153A & 153B IPC),2014,1,0,1
Mizoram,Promoting enmity on ground of religion race and place of Birth (Section 153A IPC),2014,1,0,1
Mizoram,Imputation & assertions prejudicial to national integration (Section 153B IPC),2014,0,0,0
Mizoram,Extortion (Section 384 - 389 IPC),2014,26,0,26
Mizoram,Disclosure of Identity of Victims (Section 228 A IPC),2014,0,0,0
Mizoram,Incidence of Rash Driving (Section 279 IPC Read with 337 & 338),2014,20,0,20
Mizoram,Human Trafficking (Section 370 & 370A IPC),2014,0,0,0
Mizoram,Unnatural Offences U/s 377 IPC,2014,4,0,4
Mizoram,Other IPC crimes,2014,218,9,227
Mizoram,Total Cognizable IPC crimes,2014,2350,54,2404
Nagaland,Murder (Section 302 IPC),2014,45,3,48
Nagaland,Attempt to commit Murder (Section 307 IPC),2014,43,0,43
Nagaland,Culpable Homicide not amounting to Murder (Section 304 IPC),2014,3,0,3
Nagaland,Attempt to commit Culpable Homicide (Section 308 IPC),2014,0,0,0
Nagaland,Rape (Section 376 IPC),2014,42,0,42
Nagaland,Custodial Rape,2014,0,0,0
Nagaland,Gang Rape,2014,0,0,0
Nagaland,Other Rape,2014,0,0,0
Nagaland,Rape other than Custodial,2014,42,0,42
Nagaland,Gang Rape,2014,6,0,6
Nagaland,Other Rape,2014,36,0,36
Nagaland,Attempt to commit Rape (Section 376/511 IPC),2014,3,0,3
Nagaland,"Kidnapping & Abduction_Total (Section 3,364,364A, 366-369 IPC)",2014,50,1,51
Nagaland,Kidnapping & Abduction (Section 363 IPC),2014,7,1,8
Nagaland,Kidnaping & Abduction in order to Murder (Section 364 IPC),2014,0,0,0
Nagaland,Kidnapping for Ransom (Section 364A IPC),2014,6,0,6
Nagaland,Kidnapping & Abduction of Women to compel her for marriage (Section 366 IPC),2014,2,0,2
Nagaland,Other Kidnapping,2014,35,0,35
Nagaland,"Dacoity (Section 395,396-398 IPC)",2014,8,0,8
Nagaland,Dacoity with Murder (Section 396 IPC),2014,0,0,0
Nagaland,Other Dacoity,2014,8,0,8
Nagaland,Making Preparation and Assembly for committing Dacoity (Section 399 & 402 IPC),2014,0,0,0
Nagaland,"Robbery (Section 392 to 394, 397 and 398 IPC)",2014,40,1,41
Nagaland,Criminal Trespass/Burglary_Total (Section 453 to 460 IPC),2014,39,0,39
Nagaland,"Criminal Trespass/Burglary (Section 455, 457 & 458 IPC)",2014,33,0,33
Nagaland,"House Trespass & House Breaking (Section 453,454,456,459 & 460 IPC)",2014,6,0,6
Nagaland,Theft (Section 379 to 382 IPC),2014,406,3,409
Nagaland,Auto Theft,2014,193,0,193
Nagaland,Other Thefts,2014,213,3,216
Nagaland,"Unlawful Assembly (Section 143,144 & 145)",2014,0,0,0
Nagaland,"Riots (Section 147, 148, 149, 150 & 151 IPC)",2014,4,0,4
Nagaland,Communal,2014,0,0,0
Nagaland,Industrial,2014,0,0,0
Nagaland,Political,2014,0,0,0
Nagaland,Caste Conflict,2014,2,0,2
Nagaland,SC/STs Vs. Non-SCs/STs,2014,0,0,0
Nagaland,Other Caste Riots,2014,2,0,2
Nagaland,Agrarian,2014,0,0,0
Nagaland,Students,2014,0,0,0
Nagaland,Sectarian,2014,0,0,0
Nagaland,Other Riots,2014,2,0,2
Nagaland,Criminal Breach of Trust (Section 406 to 409 IPC),2014,12,0,12
Nagaland,Cheating (Section 420 IPC),2014,40,6,46
Nagaland,"Forgery (Section 465, 468 & 471 IPC)",2014,12,1,13
Nagaland,"Counterfeiting (Section 231-235,237-240, 242-243, 255 and 489-A to 489-E IPC)",2014,6,1,7
Nagaland,"Offences related to Counterfeit Coin (Section 231-235,237, 238-240 & 242-243 IPC)",2014,1,0,1
Nagaland,Counterfeiting Government Stamp (Section 255 IPC),2014,0,0,0
Nagaland,Counterfeit currency & Bank notes (Section 489-A to 489-E IPC),2014,5,1,6
Nagaland,Counterfeiting currency notes or Bank notes (Section 489A IPC),2014,0,0,0
Nagaland,Using forged or counterfeit currency/Bank notes (Section 489B IPC),2014,1,0,1
Nagaland,Possession of forged or counterfeiting currency / Bank notes (Section 489C IPC),2014,3,0,3
Nagaland,Make/Possess materials for forging or counterfeiting currency/Bank notes (Section 489D IPC),2014,1,1,2
Nagaland,Make/Use documents resembling currency notes/Bank notes (Section 489 E IPC),2014,0,0,0
Nagaland,Arson (Section 435-436 & 438 IPC),2014,7,0,7
Nagaland,"Grievous Hurt (Section 325,326,326A & 326 B IPC)",2014,25,0,25
Nagaland,Grievous Hurt (Section 325 & 326 IPC),2014,25,0,25
Nagaland,Acid attack (Section 326A IPC),2014,0,0,0
Nagaland,Attempt to Acid Attack (Section 326B IPC),2014,0,0,0
Nagaland,Dowry Deaths (Section 304-B IPC),2014,0,0,0
Nagaland,Assault on women with intent to outrage her Modesty (Section 354 IPC),2014,14,1,15
Nagaland,Sexual Harassment (Section 354A IPC),2014,5,0,5
Nagaland,Assault on women with intent to Disrobe (Section 354B IPC),2014,4,0,4
Nagaland,Voyeurism (Section 354C IPC),2014,0,0,0
Nagaland,Stalking (Section 354D IPC),2014,1,0,1
Nagaland,Others,2014,4,1,5
Nagaland,Insult to the Modesty of Women (Section 509 IPC),2014,1,0,1
Nagaland,At Office premises,2014,0,0,0
Nagaland,Places related to work other than Office,2014,0,0,0
Nagaland,In Public Transport system,2014,0,0,0
Nagaland,In Other Places,2014,1,0,1
Nagaland,Cruelty by Husband or his Relatives (Section 498-A IPC),2014,3,0,3
Nagaland,Importation of Girls from Foreign Country (Section 366-B IPC),2014,0,0,0
Nagaland,Causing Death by Negligence (Section 304-A IPC),2014,15,0,15
Nagaland,Deaths due to negligent driving/act,2014,12,0,12
Nagaland,Deaths due to Other Causes,2014,3,0,3
Nagaland,"Offences against State (Section 121, 121A, 122, 123, 124-A IPC)",2014,0,0,0
Nagaland,Sedition (Section 124A IPC),2014,0,0,0
Nagaland,Other offences against State,2014,0,0,0
Nagaland,Offences promoting enmity between different groups (Section 153A & 153B IPC),2014,0,0,0
Nagaland,Promoting enmity on ground of religion race and place of Birth (Section 153A IPC),2014,0,0,0
Nagaland,Imputation & assertions prejudicial to national integration (Section 153B IPC),2014,0,0,0
Nagaland,Extortion (Section 384 - 389 IPC),2014,127,1,128
Nagaland,Disclosure of Identity of Victims (Section 228 A IPC),2014,0,0,0
Nagaland,Incidence of Rash Driving (Section 279 IPC Read with 337 & 338),2014,2,0,2
Nagaland,Human Trafficking (Section 370 & 370A IPC),2014,3,0,3
Nagaland,Unnatural Offences U/s 377 IPC,2014,0,0,0
Nagaland,Other IPC crimes,2014,169,3,172
Nagaland,Total Cognizable IPC crimes,2014,1119,21,1140
Odisha,Murder (Section 302 IPC),2014,2066,238,2304
Odisha,Attempt to commit Murder (Section 307 IPC),2014,3644,220,3864
Odisha,Culpable Homicide not amounting to Murder (Section 304 IPC),2014,65,0,65
Odisha,Attempt to commit Culpable Homicide (Section 308 IPC),2014,1,0,1
Odisha,Rape (Section 376 IPC),2014,2149,43,2192
Odisha,Custodial Rape,2014,0,0,0
Odisha,Gang Rape,2014,0,0,0
Odisha,Other Rape,2014,0,0,0
Odisha,Rape other than Custodial,2014,2149,43,2192
Odisha,Gang Rape,2014,143,2,145
Odisha,Other Rape,2014,2006,41,2047
Odisha,Attempt to commit Rape (Section 376/511 IPC),2014,24,0,24
Odisha,"Kidnapping & Abduction_Total (Section 3,364,364A, 366-369 IPC)",2014,2452,63,2515
Odisha,Kidnapping & Abduction (Section 363 IPC),2014,592,9,601
Odisha,Kidnaping & Abduction in order to Murder (Section 364 IPC),2014,3,0,3
Odisha,Kidnapping for Ransom (Section 364A IPC),2014,11,0,11
Odisha,Kidnapping & Abduction of Women to compel her for marriage (Section 366 IPC),2014,1161,33,1194
Odisha,Other Kidnapping,2014,685,21,706
Odisha,"Dacoity (Section 395,396-398 IPC)",2014,2016,2,2018
Odisha,Dacoity with Murder (Section 396 IPC),2014,0,0,0
Odisha,Other Dacoity,2014,2016,2,2018
Odisha,Making Preparation and Assembly for committing Dacoity (Section 399 & 402 IPC),2014,555,0,555
Odisha,"Robbery (Section 392 to 394, 397 and 398 IPC)",2014,2660,12,2672
Odisha,Criminal Trespass/Burglary_Total (Section 453 to 460 IPC),2014,3993,16,4009
Odisha,"Criminal Trespass/Burglary (Section 455, 457 & 458 IPC)",2014,3281,15,3296
Odisha,"House Trespass & House Breaking (Section 453,454,456,459 & 460 IPC)",2014,712,1,713
Odisha,Theft (Section 379 to 382 IPC),2014,8201,56,8257
Odisha,Auto Theft,2014,2243,0,2243
Odisha,Other Thefts,2014,5958,56,6014
Odisha,"Unlawful Assembly (Section 143,144 & 145)",2014,352,40,392
Odisha,"Riots (Section 147, 148, 149, 150 & 151 IPC)",2014,11225,366,11591
Odisha,Communal,2014,8,0,8
Odisha,Industrial,2014,186,10,196
Odisha,Political,2014,203,3,206
Odisha,Caste Conflict,2014,828,10,838
Odisha,SC/STs Vs. Non-SCs/STs,2014,13,0,13
Odisha,Other Caste Riots,2014,815,10,825
Odisha,Agrarian,2014,61,2,63
Odisha,Students,2014,24,0,24
Odisha,Sectarian,2014,10,0,10
Odisha,Other Riots,2014,9905,341,10246
Odisha,Criminal Breach of Trust (Section 406 to 409 IPC),2014,598,82,680
Odisha,Cheating (Section 420 IPC),2014,2342,37,2379
Odisha,"Forgery (Section 465, 468 & 471 IPC)",2014,21,0,21
Odisha,"Counterfeiting (Section 231-235,237-240, 242-243, 255 and 489-A to 489-E IPC)",2014,27,0,27
Odisha,"Offences related to Counterfeit Coin (Section 231-235,237, 238-240 & 242-243 IPC)",2014,0,0,0
Odisha,Counterfeiting Government Stamp (Section 255 IPC),2014,0,0,0
Odisha,Counterfeit currency & Bank notes (Section 489-A to 489-E IPC),2014,27,0,27
Odisha,Counterfeiting currency notes or Bank notes (Section 489A IPC),2014,13,0,13
Odisha,Using forged or counterfeit currency/Bank notes (Section 489B IPC),2014,6,0,6
Odisha,Possession of forged or counterfeiting currency / Bank notes (Section 489C IPC),2014,8,0,8
Odisha,Make/Possess materials for forging or counterfeiting currency/Bank notes (Section 489D IPC),2014,0,0,0
Odisha,Make/Use documents resembling currency notes/Bank notes (Section 489 E IPC),2014,0,0,0
Odisha,Arson (Section 435-436 & 438 IPC),2014,563,16,579
Odisha,"Grievous Hurt (Section 325,326,326A & 326 B IPC)",2014,8630,295,8925
Odisha,Grievous Hurt (Section 325 & 326 IPC),2014,8622,295,8917
Odisha,Acid attack (Section 326A IPC),2014,8,0,8
Odisha,Attempt to Acid Attack (Section 326B IPC),2014,0,0,0
Odisha,Dowry Deaths (Section 304-B IPC),2014,1077,249,1326
Odisha,Assault on women with intent to outrage her Modesty (Section 354 IPC),2014,6353,366,6719
Odisha,Sexual Harassment (Section 354A IPC),2014,982,27,1009
Odisha,Assault on women with intent to Disrobe (Section 354B IPC),2014,1098,55,1153
Odisha,Voyeurism (Section 354C IPC),2014,23,0,23
Odisha,Stalking (Section 354D IPC),2014,124,1,125
Odisha,Others,2014,4126,283,4409
Odisha,Insult to the Modesty of Women (Section 509 IPC),2014,464,3,467
Odisha,At Office premises,2014,6,0,6
Odisha,Places related to work other than Office,2014,10,0,10
Odisha,In Public Transport system,2014,8,0,8
Odisha,In Other Places,2014,440,3,443
Odisha,Cruelty by Husband or his Relatives (Section 498-A IPC),2014,5185,1338,6523
Odisha,Importation of Girls from Foreign Country (Section 366-B IPC),2014,0,0,0
Odisha,Causing Death by Negligence (Section 304-A IPC),2014,4532,0,4532
Odisha,Deaths due to negligent driving/act,2014,4489,0,4489
Odisha,Deaths due to Other Causes,2014,43,0,43
Odisha,"Offences against State (Section 121, 121A, 122, 123, 124-A IPC)",2014,2,3,5
Odisha,Sedition (Section 124A IPC),2014,1,3,4
Odisha,Other offences against State,2014,1,0,1
Odisha,Offences promoting enmity between different groups (Section 153A & 153B IPC),2014,15,0,15
Odisha,Promoting enmity on ground of religion race and place of Birth (Section 153A IPC),2014,15,0,15
Odisha,Imputation & assertions prejudicial to national integration (Section 153B IPC),2014,0,0,0
Odisha,Extortion (Section 384 - 389 IPC),2014,443,4,447
Odisha,Disclosure of Identity of Victims (Section 228 A IPC),2014,0,0,0
Odisha,Incidence of Rash Driving (Section 279 IPC Read with 337 & 338),2014,3529,2,3531
Odisha,Human Trafficking (Section 370 & 370A IPC),2014,40,5,45
Odisha,Unnatural Offences U/s 377 IPC,2014,19,0,19
Odisha,Other IPC crimes,2014,27657,2547,30204
Odisha,Total Cognizable IPC crimes,2014,100900,6003,106903
Punjab,Murder (Section 302 IPC),2014,1231,137,1368
Punjab,Attempt to commit Murder (Section 307 IPC),2014,1889,161,2050
Punjab,Culpable Homicide not amounting to Murder (Section 304 IPC),2014,128,11,139
Punjab,Attempt to commit Culpable Homicide (Section 308 IPC),2014,76,2,78
Punjab,Rape (Section 376 IPC),2014,1179,69,1248
Punjab,Custodial Rape,2014,0,0,0
Punjab,Gang Rape,2014,0,0,0
Punjab,Other Rape,2014,0,0,0
Punjab,Rape other than Custodial,2014,1179,69,1248
Punjab,Gang Rape,2014,45,0,45
Punjab,Other Rape,2014,1134,69,1203
Punjab,Attempt to commit Rape (Section 376/511 IPC),2014,142,4,146
Punjab,"Kidnapping & Abduction_Total (Section 3,364,364A, 366-369 IPC)",2014,1136,138,1274
Punjab,Kidnapping & Abduction (Section 363 IPC),2014,111,15,126
Punjab,Kidnaping & Abduction in order to Murder (Section 364 IPC),2014,57,3,60
Punjab,Kidnapping for Ransom (Section 364A IPC),2014,8,0,8
Punjab,Kidnapping & Abduction of Women to compel her for marriage (Section 366 IPC),2014,574,82,656
Punjab,Other Kidnapping,2014,386,38,424
Punjab,"Dacoity (Section 395,396-398 IPC)",2014,152,0,152
Punjab,Dacoity with Murder (Section 396 IPC),2014,5,0,5
Punjab,Other Dacoity,2014,147,0,147
Punjab,Making Preparation and Assembly for committing Dacoity (Section 399 & 402 IPC),2014,681,4,685
Punjab,"Robbery (Section 392 to 394, 397 and 398 IPC)",2014,295,1,296
Punjab,Criminal Trespass/Burglary_Total (Section 453 to 460 IPC),2014,2315,53,2368
Punjab,"Criminal Trespass/Burglary (Section 455, 457 & 458 IPC)",2014,1466,37,1503
Punjab,"House Trespass & House Breaking (Section 453,454,456,459 & 460 IPC)",2014,849,16,865
Punjab,Theft (Section 379 to 382 IPC),2014,4440,159,4599
Punjab,Auto Theft,2014,1449,7,1456
Punjab,Other Thefts,2014,2991,152,3143
Punjab,"Unlawful Assembly (Section 143,144 & 145)",2014,0,0,0
Punjab,"Riots (Section 147, 148, 149, 150 & 151 IPC)",2014,0,0,0
Punjab,Communal,2014,0,0,0
Punjab,Industrial,2014,0,0,0
Punjab,Political,2014,0,0,0
Punjab,Caste Conflict,2014,0,0,0
Punjab,SC/STs Vs. Non-SCs/STs,2014,0,0,0
Punjab,Other Caste Riots,2014,0,0,0
Punjab,Agrarian,2014,0,0,0
Punjab,Students,2014,0,0,0
Punjab,Sectarian,2014,0,0,0
Punjab,Other Riots,2014,0,0,0
Punjab,Criminal Breach of Trust (Section 406 to 409 IPC),2014,299,20,319
Punjab,Cheating (Section 420 IPC),2014,4892,371,5263
Punjab,"Forgery (Section 465, 468 & 471 IPC)",2014,58,5,63
Punjab,"Counterfeiting (Section 231-235,237-240, 242-243, 255 and 489-A to 489-E IPC)",2014,45,2,47
Punjab,"Offences related to Counterfeit Coin (Section 231-235,237, 238-240 & 242-243 IPC)",2014,0,0,0
Punjab,Counterfeiting Government Stamp (Section 255 IPC),2014,0,0,0
Punjab,Counterfeit currency & Bank notes (Section 489-A to 489-E IPC),2014,45,2,47
Punjab,Counterfeiting currency notes or Bank notes (Section 489A IPC),2014,29,2,31
Punjab,Using forged or counterfeit currency/Bank notes (Section 489B IPC),2014,2,0,2
Punjab,Possession of forged or counterfeiting currency / Bank notes (Section 489C IPC),2014,3,0,3
Punjab,Make/Possess materials for forging or counterfeiting currency/Bank notes (Section 489D IPC),2014,0,0,0
Punjab,Make/Use documents resembling currency notes/Bank notes (Section 489 E IPC),2014,11,0,11
Punjab,Arson (Section 435-436 & 438 IPC),2014,92,3,95
Punjab,"Grievous Hurt (Section 325,326,326A & 326 B IPC)",2014,5400,531,5931
Punjab,Grievous Hurt (Section 325 & 326 IPC),2014,5386,531,5917
Punjab,Acid attack (Section 326A IPC),2014,12,0,12
Punjab,Attempt to Acid Attack (Section 326B IPC),2014,2,0,2
Punjab,Dowry Deaths (Section 304-B IPC),2014,132,54,186
Punjab,Assault on women with intent to outrage her Modesty (Section 354 IPC),2014,1230,39,1269
Punjab,Sexual Harassment (Section 354A IPC),2014,348,18,366
Punjab,Assault on women with intent to Disrobe (Section 354B IPC),2014,60,0,60
Punjab,Voyeurism (Section 354C IPC),2014,88,0,88
Punjab,Stalking (Section 354D IPC),2014,55,0,55
Punjab,Others,2014,679,21,700
Punjab,Insult to the Modesty of Women (Section 509 IPC),2014,43,0,43
Punjab,At Office premises,2014,0,0,0
Punjab,Places related to work other than Office,2014,3,0,3
Punjab,In Public Transport system,2014,0,0,0
Punjab,In Other Places,2014,40,0,40
Punjab,Cruelty by Husband or his Relatives (Section 498-A IPC),2014,2119,601,2720
Punjab,Importation of Girls from Foreign Country (Section 366-B IPC),2014,0,0,0
Punjab,Causing Death by Negligence (Section 304-A IPC),2014,2408,22,2430
Punjab,Deaths due to negligent driving/act,2014,2380,19,2399
Punjab,Deaths due to Other Causes,2014,28,3,31
Punjab,"Offences against State (Section 121, 121A, 122, 123, 124-A IPC)",2014,0,0,0
Punjab,Sedition (Section 124A IPC),2014,0,0,0
Punjab,Other offences against State,2014,0,0,0
Punjab,Offences promoting enmity between different groups (Section 153A & 153B IPC),2014,0,0,0
Punjab,Promoting enmity on ground of religion race and place of Birth (Section 153A IPC),2014,0,0,0
Punjab,Imputation & assertions prejudicial to national integration (Section 153B IPC),2014,0,0,0
Punjab,Extortion (Section 384 - 389 IPC),2014,39,2,41
Punjab,Disclosure of Identity of Victims (Section 228 A IPC),2014,0,0,0
Punjab,Incidence of Rash Driving (Section 279 IPC Read with 337 & 338),2014,1353,7,1360
Punjab,Human Trafficking (Section 370 & 370A IPC),2014,1,0,1
Punjab,Unnatural Offences U/s 377 IPC,2014,79,3,82
Punjab,Other IPC crimes,2014,11621,764,12385
Punjab,Total Cognizable IPC crimes,2014,43475,3163,46638
Rajasthan,Murder (Section 302 IPC),2014,2084,161,2245
Rajasthan,Attempt to commit Murder (Section 307 IPC),2014,4445,199,4644
Rajasthan,Culpable Homicide not amounting to Murder (Section 304 IPC),2014,86,1,87
Rajasthan,Attempt to commit Culpable Homicide (Section 308 IPC),2014,414,9,423
Rajasthan,Rape (Section 376 IPC),2014,2794,54,2848
Rajasthan,Custodial Rape,2014,0,0,0
Rajasthan,Gang Rape,2014,0,0,0
Rajasthan,Other Rape,2014,0,0,0
Rajasthan,Rape other than Custodial,2014,2794,54,2848
Rajasthan,Gang Rape,2014,376,4,380
Rajasthan,Other Rape,2014,2418,50,2468
Rajasthan,Attempt to commit Rape (Section 376/511 IPC),2014,279,10,289
Rajasthan,"Kidnapping & Abduction_Total (Section 3,364,364A, 366-369 IPC)",2014,2766,100,2866
Rajasthan,Kidnapping & Abduction (Section 363 IPC),2014,470,21,491
Rajasthan,Kidnaping & Abduction in order to Murder (Section 364 IPC),2014,38,0,38
Rajasthan,Kidnapping for Ransom (Section 364A IPC),2014,53,3,56
Rajasthan,Kidnapping & Abduction of Women to compel her for marriage (Section 366 IPC),2014,1022,41,1063
Rajasthan,Other Kidnapping,2014,1183,35,1218
Rajasthan,"Dacoity (Section 395,396-398 IPC)",2014,276,0,276
Rajasthan,Dacoity with Murder (Section 396 IPC),2014,5,0,5
Rajasthan,Other Dacoity,2014,271,0,271
Rajasthan,Making Preparation and Assembly for committing Dacoity (Section 399 & 402 IPC),2014,508,6,514
Rajasthan,"Robbery (Section 392 to 394, 397 and 398 IPC)",2014,1925,26,1951
Rajasthan,Criminal Trespass/Burglary_Total (Section 453 to 460 IPC),2014,3285,112,3397
Rajasthan,"Criminal Trespass/Burglary (Section 455, 457 & 458 IPC)",2014,2298,83,2381
Rajasthan,"House Trespass & House Breaking (Section 453,454,456,459 & 460 IPC)",2014,987,29,1016
Rajasthan,Theft (Section 379 to 382 IPC),2014,9483,228,9711
Rajasthan,Auto Theft,2014,3719,2,3721
Rajasthan,Other Thefts,2014,5764,226,5990
Rajasthan,"Unlawful Assembly (Section 143,144 & 145)",2014,11388,1501,12889
Rajasthan,"Riots (Section 147, 148, 149, 150 & 151 IPC)",2014,2283,238,2521
Rajasthan,Communal,2014,36,5,41
Rajasthan,Industrial,2014,16,0,16
Rajasthan,Political,2014,0,0,0
Rajasthan,Caste Conflict,2014,0,0,0
Rajasthan,SC/STs Vs. Non-SCs/STs,2014,0,0,0
Rajasthan,Other Caste Riots,2014,0,0,0
Rajasthan,Agrarian,2014,172,9,181
Rajasthan,Students,2014,0,0,0
Rajasthan,Sectarian,2014,0,0,0
Rajasthan,Other Riots,2014,2059,224,2283
Rajasthan,Criminal Breach of Trust (Section 406 to 409 IPC),2014,239,8,247
Rajasthan,Cheating (Section 420 IPC),2014,5016,355,5371
Rajasthan,"Forgery (Section 465, 468 & 471 IPC)",2014,1226,56,1282
Rajasthan,"Counterfeiting (Section 231-235,237-240, 242-243, 255 and 489-A to 489-E IPC)",2014,51,1,52
Rajasthan,"Offences related to Counterfeit Coin (Section 231-235,237, 238-240 & 242-243 IPC)",2014,5,0,5
Rajasthan,Counterfeiting Government Stamp (Section 255 IPC),2014,0,0,0
Rajasthan,Counterfeit currency & Bank notes (Section 489-A to 489-E IPC),2014,46,1,47
Rajasthan,Counterfeiting currency notes or Bank notes (Section 489A IPC),2014,27,0,27
Rajasthan,Using forged or counterfeit currency/Bank notes (Section 489B IPC),2014,16,1,17
Rajasthan,Possession of forged or counterfeiting currency / Bank notes (Section 489C IPC),2014,3,0,3
Rajasthan,Make/Possess materials for forging or counterfeiting currency/Bank notes (Section 489D IPC),2014,0,0,0
Rajasthan,Make/Use documents resembling currency notes/Bank notes (Section 489 E IPC),2014,0,0,0
Rajasthan,Arson (Section 435-436 & 438 IPC),2014,496,14,510
Rajasthan,"Grievous Hurt (Section 325,326,326A & 326 B IPC)",2014,5286,332,5618
Rajasthan,Grievous Hurt (Section 325 & 326 IPC),2014,5273,332,5605
Rajasthan,Acid attack (Section 326A IPC),2014,13,0,13
Rajasthan,Attempt to Acid Attack (Section 326B IPC),2014,0,0,0
Rajasthan,Dowry Deaths (Section 304-B IPC),2014,437,94,531
Rajasthan,Assault on women with intent to outrage her Modesty (Section 354 IPC),2014,5714,174,5888
Rajasthan,Sexual Harassment (Section 354A IPC),2014,831,10,841
Rajasthan,Assault on women with intent to Disrobe (Section 354B IPC),2014,222,18,240
Rajasthan,Voyeurism (Section 354C IPC),2014,27,0,27
Rajasthan,Stalking (Section 354D IPC),2014,81,0,81
Rajasthan,Others,2014,4553,146,4699
Rajasthan,Insult to the Modesty of Women (Section 509 IPC),2014,13,0,13
Rajasthan,At Office premises,2014,0,0,0
Rajasthan,Places related to work other than Office,2014,0,0,0
Rajasthan,In Public Transport system,2014,1,0,1
Rajasthan,In Other Places,2014,12,0,12
Rajasthan,Cruelty by Husband or his Relatives (Section 498-A IPC),2014,9840,1743,11583
Rajasthan,Importation of Girls from Foreign Country (Section 366-B IPC),2014,0,0,0
Rajasthan,Causing Death by Negligence (Section 304-A IPC),2014,7747,10,7757
Rajasthan,Deaths due to negligent driving/act,2014,7689,10,7699
Rajasthan,Deaths due to Other Causes,2014,58,0,58
Rajasthan,"Offences against State (Section 121, 121A, 122, 123, 124-A IPC)",2014,0,0,0
Rajasthan,Sedition (Section 124A IPC),2014,0,0,0
Rajasthan,Other offences against State,2014,0,0,0
Rajasthan,Offences promoting enmity between different groups (Section 153A & 153B IPC),2014,29,0,29
Rajasthan,Promoting enmity on ground of religion race and place of Birth (Section 153A IPC),2014,29,0,29
Rajasthan,Imputation & assertions prejudicial to national integration (Section 153B IPC),2014,0,0,0
Rajasthan,Extortion (Section 384 - 389 IPC),2014,363,21,384
Rajasthan,Disclosure of Identity of Victims (Section 228 A IPC),2014,0,0,0
Rajasthan,Incidence of Rash Driving (Section 279 IPC Read with 337 & 338),2014,12740,88,12828
Rajasthan,Human Trafficking (Section 370 & 370A IPC),2014,14,2,16
Rajasthan,Unnatural Offences U/s 377 IPC,2014,39,1,40
Rajasthan,Other IPC crimes,2014,100148,10643,110791
Rajasthan,Total Cognizable IPC crimes,2014,191414,16187,207601
Sikkim,Murder (Section 302 IPC),2014,25,1,26
Sikkim,Attempt to commit Murder (Section 307 IPC),2014,15,0,15
Sikkim,Culpable Homicide not amounting to Murder (Section 304 IPC),2014,4,0,4
Sikkim,Attempt to commit Culpable Homicide (Section 308 IPC),2014,0,0,0
Sikkim,Rape (Section 376 IPC),2014,107,0,107
Sikkim,Custodial Rape,2014,0,0,0
Sikkim,Gang Rape,2014,0,0,0
Sikkim,Other Rape,2014,0,0,0
Sikkim,Rape other than Custodial,2014,107,0,107
Sikkim,Gang Rape,2014,2,0,2
Sikkim,Other Rape,2014,105,0,105
Sikkim,Attempt to commit Rape (Section 376/511 IPC),2014,10,0,10
Sikkim,"Kidnapping & Abduction_Total (Section 3,364,364A, 366-369 IPC)",2014,35,1,36
Sikkim,Kidnapping & Abduction (Section 363 IPC),2014,13,0,13
Sikkim,Kidnaping & Abduction in order to Murder (Section 364 IPC),2014,0,0,0
Sikkim,Kidnapping for Ransom (Section 364A IPC),2014,0,0,0
Sikkim,Kidnapping & Abduction of Women to compel her for marriage (Section 366 IPC),2014,0,0,0
Sikkim,Other Kidnapping,2014,22,1,23
Sikkim,"Dacoity (Section 395,396-398 IPC)",2014,6,0,6
Sikkim,Dacoity with Murder (Section 396 IPC),2014,0,0,0
Sikkim,Other Dacoity,2014,6,0,6
Sikkim,Making Preparation and Assembly for committing Dacoity (Section 399 & 402 IPC),2014,0,0,0
Sikkim,"Robbery (Section 392 to 394, 397 and 398 IPC)",2014,24,0,24
Sikkim,Criminal Trespass/Burglary_Total (Section 453 to 460 IPC),2014,115,2,117
Sikkim,"Criminal Trespass/Burglary (Section 455, 457 & 458 IPC)",2014,80,1,81
Sikkim,"House Trespass & House Breaking (Section 453,454,456,459 & 460 IPC)",2014,35,1,36
Sikkim,Theft (Section 379 to 382 IPC),2014,152,0,152
Sikkim,Auto Theft,2014,14,0,14
Sikkim,Other Thefts,2014,138,0,138
Sikkim,"Unlawful Assembly (Section 143,144 & 145)",2014,17,0,17
Sikkim,"Riots (Section 147, 148, 149, 150 & 151 IPC)",2014,665,82,747
Sikkim,Communal,2014,3,0,3
Sikkim,Industrial,2014,0,0,0
Sikkim,Political,2014,571,58,629
Sikkim,Caste Conflict,2014,14,4,18
Sikkim,SC/STs Vs. Non-SCs/STs,2014,0,0,0
Sikkim,Other Caste Riots,2014,14,4,18
Sikkim,Agrarian,2014,0,0,0
Sikkim,Students,2014,54,20,74
Sikkim,Sectarian,2014,0,0,0
Sikkim,Other Riots,2014,23,0,23
Sikkim,Criminal Breach of Trust (Section 406 to 409 IPC),2014,14,0,14
Sikkim,Cheating (Section 420 IPC),2014,69,0,69
Sikkim,"Forgery (Section 465, 468 & 471 IPC)",2014,7,0,7
Sikkim,"Counterfeiting (Section 231-235,237-240, 242-243, 255 and 489-A to 489-E IPC)",2014,4,1,5
Sikkim,"Offences related to Counterfeit Coin (Section 231-235,237, 238-240 & 242-243 IPC)",2014,0,0,0
Sikkim,Counterfeiting Government Stamp (Section 255 IPC),2014,0,0,0
Sikkim,Counterfeit currency & Bank notes (Section 489-A to 489-E IPC),2014,4,1,5
Sikkim,Counterfeiting currency notes or Bank notes (Section 489A IPC),2014,0,0,0
Sikkim,Using forged or counterfeit currency/Bank notes (Section 489B IPC),2014,4,1,5
Sikkim,Possession of forged or counterfeiting currency / Bank notes (Section 489C IPC),2014,0,0,0
Sikkim,Make/Possess materials for forging or counterfeiting currency/Bank notes (Section 489D IPC),2014,0,0,0
Sikkim,Make/Use documents resembling currency notes/Bank notes (Section 489 E IPC),2014,0,0,0
Sikkim,Arson (Section 435-436 & 438 IPC),2014,9,0,9
Sikkim,"Grievous Hurt (Section 325,326,326A & 326 B IPC)",2014,80,1,81
Sikkim,Grievous Hurt (Section 325 & 326 IPC),2014,78,1,79
Sikkim,Acid attack (Section 326A IPC),2014,2,0,2
Sikkim,Attempt to Acid Attack (Section 326B IPC),2014,0,0,0
Sikkim,Dowry Deaths (Section 304-B IPC),2014,0,0,0
Sikkim,Assault on women with intent to outrage her Modesty (Section 354 IPC),2014,53,0,53
Sikkim,Sexual Harassment (Section 354A IPC),2014,17,0,17
Sikkim,Assault on women with intent to Disrobe (Section 354B IPC),2014,1,0,1
Sikkim,Voyeurism (Section 354C IPC),2014,0,0,0
Sikkim,Stalking (Section 354D IPC),2014,4,0,4
Sikkim,Others,2014,31,0,31
Sikkim,Insult to the Modesty of Women (Section 509 IPC),2014,3,0,3
Sikkim,At Office premises,2014,0,0,0
Sikkim,Places related to work other than Office,2014,0,0,0
Sikkim,In Public Transport system,2014,0,0,0
Sikkim,In Other Places,2014,3,0,3
Sikkim,Cruelty by Husband or his Relatives (Section 498-A IPC),2014,5,1,6
Sikkim,Importation of Girls from Foreign Country (Section 366-B IPC),2014,0,0,0
Sikkim,Causing Death by Negligence (Section 304-A IPC),2014,82,1,83
Sikkim,Deaths due to negligent driving/act,2014,80,0,80
Sikkim,Deaths due to Other Causes,2014,2,1,3
Sikkim,"Offences against State (Section 121, 121A, 122, 123, 124-A IPC)",2014,0,0,0
Sikkim,Sedition (Section 124A IPC),2014,0,0,0
Sikkim,Other offences against State,2014,0,0,0
Sikkim,Offences promoting enmity between different groups (Section 153A & 153B IPC),2014,0,0,0
Sikkim,Promoting enmity on ground of religion race and place of Birth (Section 153A IPC),2014,0,0,0
Sikkim,Imputation & assertions prejudicial to national integration (Section 153B IPC),2014,0,0,0
Sikkim,Extortion (Section 384 - 389 IPC),2014,4,0,4
Sikkim,Disclosure of Identity of Victims (Section 228 A IPC),2014,0,0,0
Sikkim,Incidence of Rash Driving (Section 279 IPC Read with 337 & 338),2014,165,0,165
Sikkim,Human Trafficking (Section 370 & 370A IPC),2014,0,0,0
Sikkim,Unnatural Offences U/s 377 IPC,2014,1,0,1
Sikkim,Other IPC crimes,2014,276,26,302
Sikkim,Total Cognizable IPC crimes,2014,1947,116,2063
Tamil Nadu,Murder (Section 302 IPC),2014,4020,254,4274
Tamil Nadu,Attempt to commit Murder (Section 307 IPC),2014,6111,236,6347
Tamil Nadu,Culpable Homicide not amounting to Murder (Section 304 IPC),2014,60,7,67
Tamil Nadu,Attempt to commit Culpable Homicide (Section 308 IPC),2014,0,0,0
Tamil Nadu,Rape (Section 376 IPC),2014,736,28,764
Tamil Nadu,Custodial Rape,2014,0,0,0
Tamil Nadu,Gang Rape,2014,0,0,0
Tamil Nadu,Other Rape,2014,0,0,0
Tamil Nadu,Rape other than Custodial,2014,736,28,764
Tamil Nadu,Gang Rape,2014,6,0,6
Tamil Nadu,Other Rape,2014,730,28,758
Tamil Nadu,Attempt to commit Rape (Section 376/511 IPC),2014,18,0,18
Tamil Nadu,"Kidnapping & Abduction_Total (Section 3,364,364A, 366-369 IPC)",2014,1878,85,1963
Tamil Nadu,Kidnapping & Abduction (Section 363 IPC),2014,338,24,362
Tamil Nadu,Kidnaping & Abduction in order to Murder (Section 364 IPC),2014,0,0,0
Tamil Nadu,Kidnapping for Ransom (Section 364A IPC),2014,15,0,15
Tamil Nadu,Kidnapping & Abduction of Women to compel her for marriage (Section 366 IPC),2014,1080,36,1116
Tamil Nadu,Other Kidnapping,2014,445,25,470
Tamil Nadu,"Dacoity (Section 395,396-398 IPC)",2014,491,3,494
Tamil Nadu,Dacoity with Murder (Section 396 IPC),2014,0,0,0
Tamil Nadu,Other Dacoity,2014,491,3,494
Tamil Nadu,Making Preparation and Assembly for committing Dacoity (Section 399 & 402 IPC),2014,312,0,312
Tamil Nadu,"Robbery (Section 392 to 394, 397 and 398 IPC)",2014,2365,30,2395
Tamil Nadu,Criminal Trespass/Burglary_Total (Section 453 to 460 IPC),2014,7425,48,7473
Tamil Nadu,"Criminal Trespass/Burglary (Section 455, 457 & 458 IPC)",2014,4045,23,4068
Tamil Nadu,"House Trespass & House Breaking (Section 453,454,456,459 & 460 IPC)",2014,3380,25,3405
Tamil Nadu,Theft (Section 379 to 382 IPC),2014,18509,580,19089
Tamil Nadu,Auto Theft,2014,6450,4,6454
Tamil Nadu,Other Thefts,2014,12059,576,12635
Tamil Nadu,"Unlawful Assembly (Section 143,144 & 145)",2014,9994,665,10659
Tamil Nadu,"Riots (Section 147, 148, 149, 150 & 151 IPC)",2014,10678,954,11632
Tamil Nadu,Communal,2014,541,5,546
Tamil Nadu,Industrial,2014,0,0,0
Tamil Nadu,Political,2014,55,0,55
Tamil Nadu,Caste Conflict,2014,708,82,790
Tamil Nadu,SC/STs Vs. Non-SCs/STs,2014,223,10,233
Tamil Nadu,Other Caste Riots,2014,485,72,557
Tamil Nadu,Agrarian,2014,0,0,0
Tamil Nadu,Students,2014,66,0,66
Tamil Nadu,Sectarian,2014,35,0,35
Tamil Nadu,Other Riots,2014,9273,867,10140
Tamil Nadu,Criminal Breach of Trust (Section 406 to 409 IPC),2014,322,11,333
Tamil Nadu,Cheating (Section 420 IPC),2014,4717,254,4971
Tamil Nadu,"Forgery (Section 465, 468 & 471 IPC)",2014,194,5,199
Tamil Nadu,"Counterfeiting (Section 231-235,237-240, 242-243, 255 and 489-A to 489-E IPC)",2014,201,2,203
Tamil Nadu,"Offences related to Counterfeit Coin (Section 231-235,237, 238-240 & 242-243 IPC)",2014,0,0,0
Tamil Nadu,Counterfeiting Government Stamp (Section 255 IPC),2014,0,0,0
Tamil Nadu,Counterfeit currency & Bank notes (Section 489-A to 489-E IPC),2014,201,2,203
Tamil Nadu,Counterfeiting currency notes or Bank notes (Section 489A IPC),2014,63,1,64
Tamil Nadu,Using forged or counterfeit currency/Bank notes (Section 489B IPC),2014,120,1,121
Tamil Nadu,Possession of forged or counterfeiting currency / Bank notes (Section 489C IPC),2014,18,0,18
Tamil Nadu,Make/Possess materials for forging or counterfeiting currency/Bank notes (Section 489D IPC),2014,0,0,0
Tamil Nadu,Make/Use documents resembling currency notes/Bank notes (Section 489 E IPC),2014,0,0,0
Tamil Nadu,Arson (Section 435-436 & 438 IPC),2014,771,26,797
Tamil Nadu,"Grievous Hurt (Section 325,326,326A & 326 B IPC)",2014,3400,126,3526
Tamil Nadu,Grievous Hurt (Section 325 & 326 IPC),2014,3395,122,3517
Tamil Nadu,Acid attack (Section 326A IPC),2014,5,4,9
Tamil Nadu,Attempt to Acid Attack (Section 326B IPC),2014,0,0,0
Tamil Nadu,Dowry Deaths (Section 304-B IPC),2014,224,68,292
Tamil Nadu,Assault on women with intent to outrage her Modesty (Section 354 IPC),2014,1431,186,1617
Tamil Nadu,Sexual Harassment (Section 354A IPC),2014,55,3,58
Tamil Nadu,Assault on women with intent to Disrobe (Section 354B IPC),2014,97,0,97
Tamil Nadu,Voyeurism (Section 354C IPC),2014,1,0,1
Tamil Nadu,Stalking (Section 354D IPC),2014,1,0,1
Tamil Nadu,Others,2014,1277,183,1460
Tamil Nadu,Insult to the Modesty of Women (Section 509 IPC),2014,423,0,423
Tamil Nadu,At Office premises,2014,2,0,2
Tamil Nadu,Places related to work other than Office,2014,308,0,308
Tamil Nadu,In Public Transport system,2014,0,0,0
Tamil Nadu,In Other Places,2014,113,0,113
Tamil Nadu,Cruelty by Husband or his Relatives (Section 498-A IPC),2014,2473,819,3292
Tamil Nadu,Importation of Girls from Foreign Country (Section 366-B IPC),2014,0,0,0
Tamil Nadu,Causing Death by Negligence (Section 304-A IPC),2014,15991,26,16017
Tamil Nadu,Deaths due to negligent driving/act,2014,15768,24,15792
Tamil Nadu,Deaths due to Other Causes,2014,223,2,225
Tamil Nadu,"Offences against State (Section 121, 121A, 122, 123, 124-A IPC)",2014,0,0,0
Tamil Nadu,Sedition (Section 124A IPC),2014,0,0,0
Tamil Nadu,Other offences against State,2014,0,0,0
Tamil Nadu,Offences promoting enmity between different groups (Section 153A & 153B IPC),2014,26,0,26
Tamil Nadu,Promoting enmity on ground of religion race and place of Birth (Section 153A IPC),2014,26,0,26
Tamil Nadu,Imputation & assertions prejudicial to national integration (Section 153B IPC),2014,0,0,0
Tamil Nadu,Extortion (Section 384 - 389 IPC),2014,738,0,738
Tamil Nadu,Disclosure of Identity of Victims (Section 228 A IPC),2014,1,0,1
Tamil Nadu,Incidence of Rash Driving (Section 279 IPC Read with 337 & 338),2014,51306,60,51366
Tamil Nadu,Human Trafficking (Section 370 & 370A IPC),2014,0,0,0
Tamil Nadu,Unnatural Offences U/s 377 IPC,2014,9,0,9
Tamil Nadu,Other IPC crimes,2014,104610,7905,112515
Tamil Nadu,Total Cognizable IPC crimes,2014,249434,12378,261812
Telangana,Murder (Section 302 IPC),2014,2151,257,2408
Telangana,Attempt to commit Murder (Section 307 IPC),2014,1954,93,2047
Telangana,Culpable Homicide not amounting to Murder (Section 304 IPC),2014,293,5,298
Telangana,Attempt to commit Culpable Homicide (Section 308 IPC),2014,1,0,1
Telangana,Rape (Section 376 IPC),2014,1239,8,1247
Telangana,Custodial Rape,2014,0,0,0
Telangana,Gang Rape,2014,0,0,0
Telangana,Other Rape,2014,0,0,0
Telangana,Rape other than Custodial,2014,1239,8,1247
Telangana,Gang Rape,2014,40,2,42
Telangana,Other Rape,2014,1199,6,1205
Telangana,Attempt to commit Rape (Section 376/511 IPC),2014,74,0,74
Telangana,"Kidnapping & Abduction_Total (Section 3,364,364A, 366-369 IPC)",2014,1715,45,1760
Telangana,Kidnapping & Abduction (Section 363 IPC),2014,397,16,413
Telangana,Kidnaping & Abduction in order to Murder (Section 364 IPC),2014,46,1,47
Telangana,Kidnapping for Ransom (Section 364A IPC),2014,22,1,23
Telangana,Kidnapping & Abduction of Women to compel her for marriage (Section 366 IPC),2014,663,13,676
Telangana,Other Kidnapping,2014,587,14,601
Telangana,"Dacoity (Section 395,396-398 IPC)",2014,366,7,373
Telangana,Dacoity with Murder (Section 396 IPC),2014,6,0,6
Telangana,Other Dacoity,2014,360,7,367
Telangana,Making Preparation and Assembly for committing Dacoity (Section 399 & 402 IPC),2014,3,0,3
Telangana,"Robbery (Section 392 to 394, 397 and 398 IPC)",2014,690,8,698
Telangana,Criminal Trespass/Burglary_Total (Section 453 to 460 IPC),2014,6687,82,6769
Telangana,"Criminal Trespass/Burglary (Section 455, 457 & 458 IPC)",2014,4048,29,4077
Telangana,"House Trespass & House Breaking (Section 453,454,456,459 & 460 IPC)",2014,2639,53,2692
Telangana,Theft (Section 379 to 382 IPC),2014,16274,428,16702
Telangana,Auto Theft,2014,4414,4,4418
Telangana,Other Thefts,2014,11860,424,12284
Telangana,"Unlawful Assembly (Section 143,144 & 145)",2014,74,0,74
Telangana,"Riots (Section 147, 148, 149, 150 & 151 IPC)",2014,4212,237,4449
Telangana,Communal,2014,87,0,87
Telangana,Industrial,2014,9,0,9
Telangana,Political,2014,229,13,242
Telangana,Caste Conflict,2014,32,0,32
Telangana,SC/STs Vs. Non-SCs/STs,2014,12,0,12
Telangana,Other Caste Riots,2014,20,0,20
Telangana,Agrarian,2014,0,0,0
Telangana,Students,2014,27,0,27
Telangana,Sectarian,2014,0,0,0
Telangana,Other Riots,2014,3828,224,4052
Telangana,Criminal Breach of Trust (Section 406 to 409 IPC),2014,1068,22,1090
Telangana,Cheating (Section 420 IPC),2014,8507,372,8879
Telangana,"Forgery (Section 465, 468 & 471 IPC)",2014,175,5,180
Telangana,"Counterfeiting (Section 231-235,237-240, 242-243, 255 and 489-A to 489-E IPC)",2014,84,3,87
Telangana,"Offences related to Counterfeit Coin (Section 231-235,237, 238-240 & 242-243 IPC)",2014,0,0,0
Telangana,Counterfeiting Government Stamp (Section 255 IPC),2014,0,0,0
Telangana,Counterfeit currency & Bank notes (Section 489-A to 489-E IPC),2014,84,3,87
Telangana,Counterfeiting currency notes or Bank notes (Section 489A IPC),2014,47,2,49
Telangana,Using forged or counterfeit currency/Bank notes (Section 489B IPC),2014,33,1,34
Telangana,Possession of forged or counterfeiting currency / Bank notes (Section 489C IPC),2014,2,0,2
Telangana,Make/Possess materials for forging or counterfeiting currency/Bank notes (Section 489D IPC),2014,2,0,2
Telangana,Make/Use documents resembling currency notes/Bank notes (Section 489 E IPC),2014,0,0,0
Telangana,Arson (Section 435-436 & 438 IPC),2014,581,7,588
Telangana,"Grievous Hurt (Section 325,326,326A & 326 B IPC)",2014,2583,133,2716
Telangana,Grievous Hurt (Section 325 & 326 IPC),2014,2583,133,2716
Telangana,Acid attack (Section 326A IPC),2014,0,0,0
Telangana,Attempt to Acid Attack (Section 326B IPC),2014,0,0,0
Telangana,Dowry Deaths (Section 304-B IPC),2014,516,206,722
Telangana,Assault on women with intent to outrage her Modesty (Section 354 IPC),2014,4022,17,4039
Telangana,Sexual Harassment (Section 354A IPC),2014,746,1,747
Telangana,Assault on women with intent to Disrobe (Section 354B IPC),2014,183,2,185
Telangana,Voyeurism (Section 354C IPC),2014,40,0,40
Telangana,Stalking (Section 354D IPC),2014,416,0,416
Telangana,Others,2014,2637,14,2651
Telangana,Insult to the Modesty of Women (Section 509 IPC),2014,1272,15,1287
Telangana,At Office premises,2014,3,0,3
Telangana,Places related to work other than Office,2014,40,0,40
Telangana,In Public Transport system,2014,4,0,4
Telangana,In Other Places,2014,1225,15,1240
Telangana,Cruelty by Husband or his Relatives (Section 498-A IPC),2014,7552,2052,9604
Telangana,Importation of Girls from Foreign Country (Section 366-B IPC),2014,0,0,0
Telangana,Causing Death by Negligence (Section 304-A IPC),2014,8391,6,8397
Telangana,Deaths due to negligent driving/act,2014,8267,6,8273
Telangana,Deaths due to Other Causes,2014,124,0,124
Telangana,"Offences against State (Section 121, 121A, 122, 123, 124-A IPC)",2014,0,0,0
Telangana,Sedition (Section 124A IPC),2014,0,0,0
Telangana,Other offences against State,2014,0,0,0
Telangana,Offences promoting enmity between different groups (Section 153A & 153B IPC),2014,13,0,13
Telangana,Promoting enmity on ground of religion race and place of Birth (Section 153A IPC),2014,13,0,13
Telangana,Imputation & assertions prejudicial to national integration (Section 153B IPC),2014,0,0,0
Telangana,Extortion (Section 384 - 389 IPC),2014,246,1,247
Telangana,Disclosure of Identity of Victims (Section 228 A IPC),2014,0,0,0
Telangana,Incidence of Rash Driving (Section 279 IPC Read with 337 & 338),2014,17006,56,17062
Telangana,Human Trafficking (Section 370 & 370A IPC),2014,60,0,60
Telangana,Unnatural Offences U/s 377 IPC,2014,10,0,10
Telangana,Other IPC crimes,2014,48643,5023,53666
Telangana,Total Cognizable IPC crimes,2014,136462,9088,145550
Tripura,Murder (Section 302 IPC),2014,166,31,197
Tripura,Attempt to commit Murder (Section 307 IPC),2014,135,3,138
Tripura,Culpable Homicide not amounting to Murder (Section 304 IPC),2014,3,1,4
Tripura,Attempt to commit Culpable Homicide (Section 308 IPC),2014,0,0,0
Tripura,Rape (Section 376 IPC),2014,246,12,258
Tripura,Custodial Rape,2014,0,0,0
Tripura,Gang Rape,2014,0,0,0
Tripura,Other Rape,2014,0,0,0
Tripura,Rape other than Custodial,2014,246,12,258
Tripura,Gang Rape,2014,36,0,36
Tripura,Other Rape,2014,210,12,222
Tripura,Attempt to commit Rape (Section 376/511 IPC),2014,36,0,36
Tripura,"Kidnapping & Abduction_Total (Section 3,364,364A, 366-369 IPC)",2014,133,1,134
Tripura,Kidnapping & Abduction (Section 363 IPC),2014,1,0,1
Tripura,Kidnaping & Abduction in order to Murder (Section 364 IPC),2014,8,0,8
Tripura,Kidnapping for Ransom (Section 364A IPC),2014,1,0,1
Tripura,Kidnapping & Abduction of Women to compel her for marriage (Section 366 IPC),2014,86,0,86
Tripura,Other Kidnapping,2014,37,1,38
Tripura,"Dacoity (Section 395,396-398 IPC)",2014,1,0,1
Tripura,Dacoity with Murder (Section 396 IPC),2014,1,0,1
Tripura,Other Dacoity,2014,0,0,0
Tripura,Making Preparation and Assembly for committing Dacoity (Section 399 & 402 IPC),2014,14,0,14
Tripura,"Robbery (Section 392 to 394, 397 and 398 IPC)",2014,51,0,51
Tripura,Criminal Trespass/Burglary_Total (Section 453 to 460 IPC),2014,163,8,171
Tripura,"Criminal Trespass/Burglary (Section 455, 457 & 458 IPC)",2014,120,3,123
Tripura,"House Trespass & House Breaking (Section 453,454,456,459 & 460 IPC)",2014,43,5,48
Tripura,Theft (Section 379 to 382 IPC),2014,256,7,263
Tripura,Auto Theft,2014,34,0,34
Tripura,Other Thefts,2014,222,7,229
Tripura,"Unlawful Assembly (Section 143,144 & 145)",2014,4,0,4
Tripura,"Riots (Section 147, 148, 149, 150 & 151 IPC)",2014,276,11,287
Tripura,Communal,2014,0,0,0
Tripura,Industrial,2014,0,0,0
Tripura,Political,2014,59,1,60
Tripura,Caste Conflict,2014,0,0,0
Tripura,SC/STs Vs. Non-SCs/STs,2014,0,0,0
Tripura,Other Caste Riots,2014,0,0,0
Tripura,Agrarian,2014,0,0,0
Tripura,Students,2014,0,0,0
Tripura,Sectarian,2014,0,0,0
Tripura,Other Riots,2014,217,10,227
Tripura,Criminal Breach of Trust (Section 406 to 409 IPC),2014,47,1,48
Tripura,Cheating (Section 420 IPC),2014,50,0,50
Tripura,"Forgery (Section 465, 468 & 471 IPC)",2014,28,0,28
Tripura,"Counterfeiting (Section 231-235,237-240, 242-243, 255 and 489-A to 489-E IPC)",2014,9,0,9
Tripura,"Offences related to Counterfeit Coin (Section 231-235,237, 238-240 & 242-243 IPC)",2014,0,0,0
Tripura,Counterfeiting Government Stamp (Section 255 IPC),2014,0,0,0
Tripura,Counterfeit currency & Bank notes (Section 489-A to 489-E IPC),2014,9,0,9
Tripura,Counterfeiting currency notes or Bank notes (Section 489A IPC),2014,0,0,0
Tripura,Using forged or counterfeit currency/Bank notes (Section 489B IPC),2014,6,0,6
Tripura,Possession of forged or counterfeiting currency / Bank notes (Section 489C IPC),2014,3,0,3
Tripura,Make/Possess materials for forging or counterfeiting currency/Bank notes (Section 489D IPC),2014,0,0,0
Tripura,Make/Use documents resembling currency notes/Bank notes (Section 489 E IPC),2014,0,0,0
Tripura,Arson (Section 435-436 & 438 IPC),2014,42,0,42
Tripura,"Grievous Hurt (Section 325,326,326A & 326 B IPC)",2014,1613,202,1815
Tripura,Grievous Hurt (Section 325 & 326 IPC),2014,1610,201,1811
Tripura,Acid attack (Section 326A IPC),2014,3,1,4
Tripura,Attempt to Acid Attack (Section 326B IPC),2014,0,0,0
Tripura,Dowry Deaths (Section 304-B IPC),2014,73,22,95
Tripura,Assault on women with intent to outrage her Modesty (Section 354 IPC),2014,411,29,440
Tripura,Sexual Harassment (Section 354A IPC),2014,74,2,76
Tripura,Assault on women with intent to Disrobe (Section 354B IPC),2014,128,22,150
Tripura,Voyeurism (Section 354C IPC),2014,0,0,0
Tripura,Stalking (Section 354D IPC),2014,3,0,3
Tripura,Others,2014,206,5,211
Tripura,Insult to the Modesty of Women (Section 509 IPC),2014,8,0,8
Tripura,At Office premises,2014,0,0,0
Tripura,Places related to work other than Office,2014,0,0,0
Tripura,In Public Transport system,2014,0,0,0
Tripura,In Other Places,2014,8,0,8
Tripura,Cruelty by Husband or his Relatives (Section 498-A IPC),2014,915,202,1117
Tripura,Importation of Girls from Foreign Country (Section 366-B IPC),2014,0,0,0
Tripura,Causing Death by Negligence (Section 304-A IPC),2014,149,0,149
Tripura,Deaths due to negligent driving/act,2014,148,0,148
Tripura,Deaths due to Other Causes,2014,1,0,1
Tripura,"Offences against State (Section 121, 121A, 122, 123, 124-A IPC)",2014,1,0,1
Tripura,Sedition (Section 124A IPC),2014,0,0,0
Tripura,Other offences against State,2014,1,0,1
Tripura,Offences promoting enmity between different groups (Section 153A & 153B IPC),2014,0,0,0
Tripura,Promoting enmity on ground of religion race and place of Birth (Section 153A IPC),2014,0,0,0
Tripura,Imputation & assertions prejudicial to national integration (Section 153B IPC),2014,0,0,0
Tripura,Extortion (Section 384 - 389 IPC),2014,9,0,9
Tripura,Disclosure of Identity of Victims (Section 228 A IPC),2014,0,0,0
Tripura,Incidence of Rash Driving (Section 279 IPC Read with 337 & 338),2014,499,0,499
Tripura,Human Trafficking (Section 370 & 370A IPC),2014,0,0,0
Tripura,Unnatural Offences U/s 377 IPC,2014,3,0,3
Tripura,Other IPC crimes,2014,692,38,730
Tripura,Total Cognizable IPC crimes,2014,6033,568,6601
Uttar Pradesh,Murder (Section 302 IPC),2014,14267,472,14739
Uttar Pradesh,Attempt to commit Murder (Section 307 IPC),2014,14196,143,14339
Uttar Pradesh,Culpable Homicide not amounting to Murder (Section 304 IPC),2014,3636,113,3749
Uttar Pradesh,Attempt to commit Culpable Homicide (Section 308 IPC),2014,1186,8,1194
Uttar Pradesh,Rape (Section 376 IPC),2014,6303,26,6329
Uttar Pradesh,Custodial Rape,2014,277,0,277
Uttar Pradesh,Gang Rape,2014,13,0,13
Uttar Pradesh,Other Rape,2014,264,0,264
Uttar Pradesh,Rape other than Custodial,2014,6026,26,6052
Uttar Pradesh,Gang Rape,2014,1641,2,1643
Uttar Pradesh,Other Rape,2014,4385,24,4409
Uttar Pradesh,Attempt to commit Rape (Section 376/511 IPC),2014,443,0,443
Uttar Pradesh,"Kidnapping & Abduction_Total (Section 3,364,364A, 366-369 IPC)",2014,25639,1027,26666
Uttar Pradesh,Kidnapping & Abduction (Section 363 IPC),2014,5586,310,5896
Uttar Pradesh,Kidnaping & Abduction in order to Murder (Section 364 IPC),2014,899,20,919
Uttar Pradesh,Kidnapping for Ransom (Section 364A IPC),2014,398,0,398
Uttar Pradesh,Kidnapping & Abduction of Women to compel her for marriage (Section 366 IPC),2014,16491,650,17141
Uttar Pradesh,Other Kidnapping,2014,2265,47,2312
Uttar Pradesh,"Dacoity (Section 395,396-398 IPC)",2014,1796,3,1799
Uttar Pradesh,Dacoity with Murder (Section 396 IPC),2014,163,0,163
Uttar Pradesh,Other Dacoity,2014,1633,3,1636
Uttar Pradesh,Making Preparation and Assembly for committing Dacoity (Section 399 & 402 IPC),2014,397,0,397
Uttar Pradesh,"Robbery (Section 392 to 394, 397 and 398 IPC)",2014,7907,21,7928
Uttar Pradesh,Criminal Trespass/Burglary_Total (Section 453 to 460 IPC),2014,5749,17,5766
Uttar Pradesh,"Criminal Trespass/Burglary (Section 455, 457 & 458 IPC)",2014,4353,12,4365
Uttar Pradesh,"House Trespass & House Breaking (Section 453,454,456,459 & 460 IPC)",2014,1396,5,1401
Uttar Pradesh,Theft (Section 379 to 382 IPC),2014,20325,138,20463
Uttar Pradesh,Auto Theft,2014,6206,0,6206
Uttar Pradesh,Other Thefts,2014,14119,138,14257
Uttar Pradesh,"Unlawful Assembly (Section 143,144 & 145)",2014,153,0,153
Uttar Pradesh,"Riots (Section 147, 148, 149, 150 & 151 IPC)",2014,47897,980,48877
Uttar Pradesh,Communal,2014,319,0,319
Uttar Pradesh,Industrial,2014,0,0,0
Uttar Pradesh,Political,2014,83,0,83
Uttar Pradesh,Caste Conflict,2014,414,0,414
Uttar Pradesh,SC/STs Vs. Non-SCs/STs,2014,378,0,378
Uttar Pradesh,Other Caste Riots,2014,36,0,36
Uttar Pradesh,Agrarian,2014,816,3,819
Uttar Pradesh,Students,2014,63,0,63
Uttar Pradesh,Sectarian,2014,7,0,7
Uttar Pradesh,Other Riots,2014,46195,977,47172
Uttar Pradesh,Criminal Breach of Trust (Section 406 to 409 IPC),2014,7528,45,7573
Uttar Pradesh,Cheating (Section 420 IPC),2014,30301,185,30486
Uttar Pradesh,"Forgery (Section 465, 468 & 471 IPC)",2014,1499,9,1508
Uttar Pradesh,"Counterfeiting (Section 231-235,237-240, 242-243, 255 and 489-A to 489-E IPC)",2014,148,0,148
Uttar Pradesh,"Offences related to Counterfeit Coin (Section 231-235,237, 238-240 & 242-243 IPC)",2014,2,0,2
Uttar Pradesh,Counterfeiting Government Stamp (Section 255 IPC),2014,0,0,0
Uttar Pradesh,Counterfeit currency & Bank notes (Section 489-A to 489-E IPC),2014,146,0,146
Uttar Pradesh,Counterfeiting currency notes or Bank notes (Section 489A IPC),2014,86,0,86
Uttar Pradesh,Using forged or counterfeit currency/Bank notes (Section 489B IPC),2014,49,0,49
Uttar Pradesh,Possession of forged or counterfeiting currency / Bank notes (Section 489C IPC),2014,11,0,11
Uttar Pradesh,Make/Possess materials for forging or counterfeiting currency/Bank notes (Section 489D IPC),2014,0,0,0
Uttar Pradesh,Make/Use documents resembling currency notes/Bank notes (Section 489 E IPC),2014,0,0,0
Uttar Pradesh,Arson (Section 435-436 & 438 IPC),2014,537,6,543
Uttar Pradesh,"Grievous Hurt (Section 325,326,326A & 326 B IPC)",2014,29769,796,30565
Uttar Pradesh,Grievous Hurt (Section 325 & 326 IPC),2014,29684,795,30479
Uttar Pradesh,Acid attack (Section 326A IPC),2014,64,1,65
Uttar Pradesh,Attempt to Acid Attack (Section 326B IPC),2014,21,0,21
Uttar Pradesh,Dowry Deaths (Section 304-B IPC),2014,8500,2160,10660
Uttar Pradesh,Assault on women with intent to outrage her Modesty (Section 354 IPC),2014,14702,0,14702
Uttar Pradesh,Sexual Harassment (Section 354A IPC),2014,7333,0,7333
Uttar Pradesh,Assault on women with intent to Disrobe (Section 354B IPC),2014,2105,0,2105
Uttar Pradesh,Voyeurism (Section 354C IPC),2014,132,0,132
Uttar Pradesh,Stalking (Section 354D IPC),2014,1341,0,1341
Uttar Pradesh,Others,2014,3791,0,3791
Uttar Pradesh,Insult to the Modesty of Women (Section 509 IPC),2014,33,0,33
Uttar Pradesh,At Office premises,2014,0,0,0
Uttar Pradesh,Places related to work other than Office,2014,2,0,2
Uttar Pradesh,In Public Transport system,2014,6,0,6
Uttar Pradesh,In Other Places,2014,25,0,25
Uttar Pradesh,Cruelty by Husband or his Relatives (Section 498-A IPC),2014,38367,8388,46755
Uttar Pradesh,Importation of Girls from Foreign Country (Section 366-B IPC),2014,0,0,0
Uttar Pradesh,Causing Death by Negligence (Section 304-A IPC),2014,12943,51,12994
Uttar Pradesh,Deaths due to negligent driving/act,2014,12816,49,12865
Uttar Pradesh,Deaths due to Other Causes,2014,127,2,129
Uttar Pradesh,"Offences against State (Section 121, 121A, 122, 123, 124-A IPC)",2014,0,0,0
Uttar Pradesh,Sedition (Section 124A IPC),2014,0,0,0
Uttar Pradesh,Other offences against State,2014,0,0,0
Uttar Pradesh,Offences promoting enmity between different groups (Section 153A & 153B IPC),2014,44,0,44
Uttar Pradesh,Promoting enmity on ground of religion race and place of Birth (Section 153A IPC),2014,44,0,44
Uttar Pradesh,Imputation & assertions prejudicial to national integration (Section 153B IPC),2014,0,0,0
Uttar Pradesh,Extortion (Section 384 - 389 IPC),2014,954,8,962
Uttar Pradesh,Disclosure of Identity of Victims (Section 228 A IPC),2014,0,0,0
Uttar Pradesh,Incidence of Rash Driving (Section 279 IPC Read with 337 & 338),2014,12892,51,12943
Uttar Pradesh,Human Trafficking (Section 370 & 370A IPC),2014,13,0,13
Uttar Pradesh,Unnatural Offences U/s 377 IPC,2014,166,0,166
Uttar Pradesh,Other IPC crimes,2014,155451,2790,158241
Uttar Pradesh,Total Cognizable IPC crimes,2014,463741,17437,481178
Uttarakhand,Murder (Section 302 IPC),2014,353,14,367
Uttarakhand,Attempt to commit Murder (Section 307 IPC),2014,267,9,276
Uttarakhand,Culpable Homicide not amounting to Murder (Section 304 IPC),2014,62,2,64
Uttarakhand,Attempt to commit Culpable Homicide (Section 308 IPC),2014,23,1,24
Uttarakhand,Rape (Section 376 IPC),2014,299,7,306
Uttarakhand,Custodial Rape,2014,0,0,0
Uttarakhand,Gang Rape,2014,0,0,0
Uttarakhand,Other Rape,2014,0,0,0
Uttarakhand,Rape other than Custodial,2014,299,7,306
Uttarakhand,Gang Rape,2014,2,0,2
Uttarakhand,Other Rape,2014,297,7,304
Uttarakhand,Attempt to commit Rape (Section 376/511 IPC),2014,53,5,58
Uttarakhand,"Kidnapping & Abduction_Total (Section 3,364,364A, 366-369 IPC)",2014,267,13,280
Uttarakhand,Kidnapping & Abduction (Section 363 IPC),2014,70,3,73
Uttarakhand,Kidnaping & Abduction in order to Murder (Section 364 IPC),2014,10,1,11
Uttarakhand,Kidnapping for Ransom (Section 364A IPC),2014,5,1,6
Uttarakhand,Kidnapping & Abduction of Women to compel her for marriage (Section 366 IPC),2014,6,1,7
Uttarakhand,Other Kidnapping,2014,176,7,183
Uttarakhand,"Dacoity (Section 395,396-398 IPC)",2014,94,0,94
Uttarakhand,Dacoity with Murder (Section 396 IPC),2014,5,0,5
Uttarakhand,Other Dacoity,2014,89,0,89
Uttarakhand,Making Preparation and Assembly for committing Dacoity (Section 399 & 402 IPC),2014,5,0,5
Uttarakhand,"Robbery (Section 392 to 394, 397 and 398 IPC)",2014,248,1,249
Uttarakhand,Criminal Trespass/Burglary_Total (Section 453 to 460 IPC),2014,398,1,399
Uttarakhand,"Criminal Trespass/Burglary (Section 455, 457 & 458 IPC)",2014,350,1,351
Uttarakhand,"House Trespass & House Breaking (Section 453,454,456,459 & 460 IPC)",2014,48,0,48
Uttarakhand,Theft (Section 379 to 382 IPC),2014,1386,9,1395
Uttarakhand,Auto Theft,2014,562,0,562
Uttarakhand,Other Thefts,2014,824,9,833
Uttarakhand,"Unlawful Assembly (Section 143,144 & 145)",2014,0,0,0
Uttarakhand,"Riots (Section 147, 148, 149, 150 & 151 IPC)",2014,1333,110,1443
Uttarakhand,Communal,2014,2,0,2
Uttarakhand,Industrial,2014,0,0,0
Uttarakhand,Political,2014,50,0,50
Uttarakhand,Caste Conflict,2014,12,3,15
Uttarakhand,SC/STs Vs. Non-SCs/STs,2014,12,3,15
Uttarakhand,Other Caste Riots,2014,0,0,0
Uttarakhand,Agrarian,2014,0,0,0
Uttarakhand,Students,2014,44,0,44
Uttarakhand,Sectarian,2014,0,0,0
Uttarakhand,Other Riots,2014,1225,107,1332
Uttarakhand,Criminal Breach of Trust (Section 406 to 409 IPC),2014,63,0,63
Uttarakhand,Cheating (Section 420 IPC),2014,267,7,274
Uttarakhand,"Forgery (Section 465, 468 & 471 IPC)",2014,96,1,97
Uttarakhand,"Counterfeiting (Section 231-235,237-240, 242-243, 255 and 489-A to 489-E IPC)",2014,7,1,8
Uttarakhand,"Offences related to Counterfeit Coin (Section 231-235,237, 238-240 & 242-243 IPC)",2014,0,0,0
Uttarakhand,Counterfeiting Government Stamp (Section 255 IPC),2014,0,0,0
Uttarakhand,Counterfeit currency & Bank notes (Section 489-A to 489-E IPC),2014,7,1,8
Uttarakhand,Counterfeiting currency notes or Bank notes (Section 489A IPC),2014,0,1,1
Uttarakhand,Using forged or counterfeit currency/Bank notes (Section 489B IPC),2014,0,0,0
Uttarakhand,Possession of forged or counterfeiting currency / Bank notes (Section 489C IPC),2014,7,0,7
Uttarakhand,Make/Possess materials for forging or counterfeiting currency/Bank notes (Section 489D IPC),2014,0,0,0
Uttarakhand,Make/Use documents resembling currency notes/Bank notes (Section 489 E IPC),2014,0,0,0
Uttarakhand,Arson (Section 435-436 & 438 IPC),2014,8,0,8
Uttarakhand,"Grievous Hurt (Section 325,326,326A & 326 B IPC)",2014,186,7,193
Uttarakhand,Grievous Hurt (Section 325 & 326 IPC),2014,186,7,193
Uttarakhand,Acid attack (Section 326A IPC),2014,0,0,0
Uttarakhand,Attempt to Acid Attack (Section 326B IPC),2014,0,0,0
Uttarakhand,Dowry Deaths (Section 304-B IPC),2014,64,28,92
Uttarakhand,Assault on women with intent to outrage her Modesty (Section 354 IPC),2014,388,7,395
Uttarakhand,Sexual Harassment (Section 354A IPC),2014,22,0,22
Uttarakhand,Assault on women with intent to Disrobe (Section 354B IPC),2014,26,1,27
Uttarakhand,Voyeurism (Section 354C IPC),2014,1,0,1
Uttarakhand,Stalking (Section 354D IPC),2014,8,0,8
Uttarakhand,Others,2014,331,6,337
Uttarakhand,Insult to the Modesty of Women (Section 509 IPC),2014,4,0,4
Uttarakhand,At Office premises,2014,0,0,0
Uttarakhand,Places related to work other than Office,2014,0,0,0
Uttarakhand,In Public Transport system,2014,0,0,0
Uttarakhand,In Other Places,2014,4,0,4
Uttarakhand,Cruelty by Husband or his Relatives (Section 498-A IPC),2014,359,113,472
Uttarakhand,Importation of Girls from Foreign Country (Section 366-B IPC),2014,0,0,0
Uttarakhand,Causing Death by Negligence (Section 304-A IPC),2014,529,0,529
Uttarakhand,Deaths due to negligent driving/act,2014,527,0,527
Uttarakhand,Deaths due to Other Causes,2014,2,0,2
Uttarakhand,"Offences against State (Section 121, 121A, 122, 123, 124-A IPC)",2014,0,0,0
Uttarakhand,Sedition (Section 124A IPC),2014,0,0,0
Uttarakhand,Other offences against State,2014,0,0,0
Uttarakhand,Offences promoting enmity between different groups (Section 153A & 153B IPC),2014,4,0,4
Uttarakhand,Promoting enmity on ground of religion race and place of Birth (Section 153A IPC),2014,4,0,4
Uttarakhand,Imputation & assertions prejudicial to national integration (Section 153B IPC),2014,0,0,0
Uttarakhand,Extortion (Section 384 - 389 IPC),2014,8,3,11
Uttarakhand,Disclosure of Identity of Victims (Section 228 A IPC),2014,0,0,0
Uttarakhand,Incidence of Rash Driving (Section 279 IPC Read with 337 & 338),2014,381,0,381
Uttarakhand,Human Trafficking (Section 370 & 370A IPC),2014,14,2,16
Uttarakhand,Unnatural Offences U/s 377 IPC,2014,16,0,16
Uttarakhand,Other IPC crimes,2014,3815,112,3927
Uttarakhand,Total Cognizable IPC crimes,2014,10997,453,11450
West Bengal,Murder (Section 302 IPC),2014,4021,317,4338
West Bengal,Attempt to commit Murder (Section 307 IPC),2014,7958,671,8629
West Bengal,Culpable Homicide not amounting to Murder (Section 304 IPC),2014,623,43,666
West Bengal,Attempt to commit Culpable Homicide (Section 308 IPC),2014,625,26,651
West Bengal,Rape (Section 376 IPC),2014,2595,7,2602
West Bengal,Custodial Rape,2014,0,0,0
West Bengal,Gang Rape,2014,0,0,0
West Bengal,Other Rape,2014,0,0,0
West Bengal,Rape other than Custodial,2014,2595,7,2602
West Bengal,Gang Rape,2014,307,1,308
West Bengal,Other Rape,2014,2288,6,2294
West Bengal,Attempt to commit Rape (Section 376/511 IPC),2014,1848,0,1848
West Bengal,"Kidnapping & Abduction_Total (Section 3,364,364A, 366-369 IPC)",2014,7662,461,8123
West Bengal,Kidnapping & Abduction (Section 363 IPC),2014,2681,147,2828
West Bengal,Kidnaping & Abduction in order to Murder (Section 364 IPC),2014,94,1,95
West Bengal,Kidnapping for Ransom (Section 364A IPC),2014,160,5,165
West Bengal,Kidnapping & Abduction of Women to compel her for marriage (Section 366 IPC),2014,1589,95,1684
West Bengal,Other Kidnapping,2014,3138,213,3351
West Bengal,"Dacoity (Section 395,396-398 IPC)",2014,628,0,628
West Bengal,Dacoity with Murder (Section 396 IPC),2014,24,0,24
West Bengal,Other Dacoity,2014,604,0,604
West Bengal,Making Preparation and Assembly for committing Dacoity (Section 399 & 402 IPC),2014,4625,0,4625
West Bengal,"Robbery (Section 392 to 394, 397 and 398 IPC)",2014,1113,2,1115
West Bengal,Criminal Trespass/Burglary_Total (Section 453 to 460 IPC),2014,369,3,372
West Bengal,"Criminal Trespass/Burglary (Section 455, 457 & 458 IPC)",2014,295,1,296
West Bengal,"House Trespass & House Breaking (Section 453,454,456,459 & 460 IPC)",2014,74,2,76
West Bengal,Theft (Section 379 to 382 IPC),2014,15981,356,16337
West Bengal,Auto Theft,2014,3703,0,3703
West Bengal,Other Thefts,2014,12278,356,12634
West Bengal,"Unlawful Assembly (Section 143,144 & 145)",2014,2914,71,2985
West Bengal,"Riots (Section 147, 148, 149, 150 & 151 IPC)",2014,12136,597,12733
West Bengal,Communal,2014,126,1,127
West Bengal,Industrial,2014,218,0,218
West Bengal,Political,2014,1486,29,1515
West Bengal,Caste Conflict,2014,40,0,40
West Bengal,SC/STs Vs. Non-SCs/STs,2014,16,0,16
West Bengal,Other Caste Riots,2014,24,0,24
West Bengal,Agrarian,2014,95,3,98
West Bengal,Students,2014,25,1,26
West Bengal,Sectarian,2014,0,0,0
West Bengal,Other Riots,2014,10146,563,10709
West Bengal,Criminal Breach of Trust (Section 406 to 409 IPC),2014,1995,96,2091
West Bengal,Cheating (Section 420 IPC),2014,6698,191,6889
West Bengal,"Forgery (Section 465, 468 & 471 IPC)",2014,577,9,586
West Bengal,"Counterfeiting (Section 231-235,237-240, 242-243, 255 and 489-A to 489-E IPC)",2014,597,15,612
West Bengal,"Offences related to Counterfeit Coin (Section 231-235,237, 238-240 & 242-243 IPC)",2014,0,0,0
West Bengal,Counterfeiting Government Stamp (Section 255 IPC),2014,0,0,0
West Bengal,Counterfeit currency & Bank notes (Section 489-A to 489-E IPC),2014,597,15,612
West Bengal,Counterfeiting currency notes or Bank notes (Section 489A IPC),2014,179,1,180
West Bengal,Using forged or counterfeit currency/Bank notes (Section 489B IPC),2014,343,14,357
West Bengal,Possession of forged or counterfeiting currency / Bank notes (Section 489C IPC),2014,52,0,52
West Bengal,Make/Possess materials for forging or counterfeiting currency/Bank notes (Section 489D IPC),2014,17,0,17
West Bengal,Make/Use documents resembling currency notes/Bank notes (Section 489 E IPC),2014,6,0,6
West Bengal,Arson (Section 435-436 & 438 IPC),2014,671,16,687
West Bengal,"Grievous Hurt (Section 325,326,326A & 326 B IPC)",2014,20509,1156,21665
West Bengal,Grievous Hurt (Section 325 & 326 IPC),2014,20470,1155,21625
West Bengal,Acid attack (Section 326A IPC),2014,36,1,37
West Bengal,Attempt to Acid Attack (Section 326B IPC),2014,3,0,3
West Bengal,Dowry Deaths (Section 304-B IPC),2014,805,189,994
West Bengal,Assault on women with intent to outrage her Modesty (Section 354 IPC),2014,6092,14,6106
West Bengal,Sexual Harassment (Section 354A IPC),2014,962,0,962
West Bengal,Assault on women with intent to Disrobe (Section 354B IPC),2014,695,2,697
West Bengal,Voyeurism (Section 354C IPC),2014,238,0,238
West Bengal,Stalking (Section 354D IPC),2014,291,0,291
West Bengal,Others,2014,3906,12,3918
West Bengal,Insult to the Modesty of Women (Section 509 IPC),2014,737,0,737
West Bengal,At Office premises,2014,4,0,4
West Bengal,Places related to work other than Office,2014,6,0,6
West Bengal,In Public Transport system,2014,10,0,10
West Bengal,In Other Places,2014,717,0,717
West Bengal,Cruelty by Husband or his Relatives (Section 498-A IPC),2014,29046,3128,32174
West Bengal,Importation of Girls from Foreign Country (Section 366-B IPC),2014,7,3,10
West Bengal,Causing Death by Negligence (Section 304-A IPC),2014,5606,43,5649
West Bengal,Deaths due to negligent driving/act,2014,4682,42,4724
West Bengal,Deaths due to Other Causes,2014,924,1,925
West Bengal,"Offences against State (Section 121, 121A, 122, 123, 124-A IPC)",2014,15,0,15
West Bengal,Sedition (Section 124A IPC),2014,0,0,0
West Bengal,Other offences against State,2014,15,0,15
West Bengal,Offences promoting enmity between different groups (Section 153A & 153B IPC),2014,44,0,44
West Bengal,Promoting enmity on ground of religion race and place of Birth (Section 153A IPC),2014,44,0,44
West Bengal,Imputation & assertions prejudicial to national integration (Section 153B IPC),2014,0,0,0
West Bengal,Extortion (Section 384 - 389 IPC),2014,560,5,565
West Bengal,Disclosure of Identity of Victims (Section 228 A IPC),2014,0,0,0
West Bengal,Incidence of Rash Driving (Section 279 IPC Read with 337 & 338),2014,11024,16,11040
West Bengal,Human Trafficking (Section 370 & 370A IPC),2014,77,8,85
West Bengal,Unnatural Offences U/s 377 IPC,2014,21,0,21
West Bengal,Other IPC crimes,2014,59166,4738,63904
West Bengal,Total Cognizable IPC crimes,2014,207345,12181,219526
A & N Islands,Murder (Section 302 IPC),2014,8,1,9
A & N Islands,Attempt to commit Murder (Section 307 IPC),2014,18,0,18
A & N Islands,Culpable Homicide not amounting to Murder (Section 304 IPC),2014,7,1,8
A & N Islands,Attempt to commit Culpable Homicide (Section 308 IPC),2014,2,0,2
A & N Islands,Rape (Section 376 IPC),2014,34,3,37
A & N Islands,Custodial Rape,2014,0,0,0
A & N Islands,Gang Rape,2014,0,0,0
A & N Islands,Other Rape,2014,0,0,0
A & N Islands,Rape other than Custodial,2014,34,3,37
A & N Islands,Gang Rape,2014,4,0,4
A & N Islands,Other Rape,2014,30,3,33
A & N Islands,Attempt to commit Rape (Section 376/511 IPC),2014,0,0,0
A & N Islands,"Kidnapping & Abduction_Total (Section 3,364,364A, 366-369 IPC)",2014,20,0,20
A & N Islands,Kidnapping & Abduction (Section 363 IPC),2014,10,0,10
A & N Islands,Kidnaping & Abduction in order to Murder (Section 364 IPC),2014,0,0,0
A & N Islands,Kidnapping for Ransom (Section 364A IPC),2014,0,0,0
A & N Islands,Kidnapping & Abduction of Women to compel her for marriage (Section 366 IPC),2014,0,0,0
A & N Islands,Other Kidnapping,2014,10,0,10
A & N Islands,"Dacoity (Section 395,396-398 IPC)",2014,0,0,0
A & N Islands,Dacoity with Murder (Section 396 IPC),2014,0,0,0
A & N Islands,Other Dacoity,2014,0,0,0
A & N Islands,Making Preparation and Assembly for committing Dacoity (Section 399 & 402 IPC),2014,0,0,0
A & N Islands,"Robbery (Section 392 to 394, 397 and 398 IPC)",2014,6,0,6
A & N Islands,Criminal Trespass/Burglary_Total (Section 453 to 460 IPC),2014,46,3,49
A & N Islands,"Criminal Trespass/Burglary (Section 455, 457 & 458 IPC)",2014,29,2,31
A & N Islands,"House Trespass & House Breaking (Section 453,454,456,459 & 460 IPC)",2014,17,1,18
A & N Islands,Theft (Section 379 to 382 IPC),2014,39,3,42
A & N Islands,Auto Theft,2014,1,0,1
A & N Islands,Other Thefts,2014,38,3,41
A & N Islands,"Unlawful Assembly (Section 143,144 & 145)",2014,8,0,8
A & N Islands,"Riots (Section 147, 148, 149, 150 & 151 IPC)",2014,63,7,70
A & N Islands,Communal,2014,0,0,0
A & N Islands,Industrial,2014,0,0,0
A & N Islands,Political,2014,0,0,0
A & N Islands,Caste Conflict,2014,0,0,0
A & N Islands,SC/STs Vs. Non-SCs/STs,2014,0,0,0
A & N Islands,Other Caste Riots,2014,0,0,0
A & N Islands,Agrarian,2014,0,0,0
A & N Islands,Students,2014,0,0,0
A & N Islands,Sectarian,2014,0,0,0
A & N Islands,Other Riots,2014,63,7,70
A & N Islands,Criminal Breach of Trust (Section 406 to 409 IPC),2014,5,0,5
A & N Islands,Cheating (Section 420 IPC),2014,20,3,23
A & N Islands,"Forgery (Section 465, 468 & 471 IPC)",2014,4,3,7
A & N Islands,"Counterfeiting (Section 231-235,237-240, 242-243, 255 and 489-A to 489-E IPC)",2014,2,0,2
A & N Islands,"Offences related to Counterfeit Coin (Section 231-235,237, 238-240 & 242-243 IPC)",2014,0,0,0
A & N Islands,Counterfeiting Government Stamp (Section 255 IPC),2014,0,0,0
A & N Islands,Counterfeit currency & Bank notes (Section 489-A to 489-E IPC),2014,2,0,2
A & N Islands,Counterfeiting currency notes or Bank notes (Section 489A IPC),2014,0,0,0
A & N Islands,Using forged or counterfeit currency/Bank notes (Section 489B IPC),2014,2,0,2
A & N Islands,Possession of forged or counterfeiting currency / Bank notes (Section 489C IPC),2014,0,0,0
A & N Islands,Make/Possess materials for forging or counterfeiting currency/Bank notes (Section 489D IPC),2014,0,0,0
A & N Islands,Make/Use documents resembling currency notes/Bank notes (Section 489 E IPC),2014,0,0,0
A & N Islands,Arson (Section 435-436 & 438 IPC),2014,5,0,5
A & N Islands,"Grievous Hurt (Section 325,326,326A & 326 B IPC)",2014,30,2,32
A & N Islands,Grievous Hurt (Section 325 & 326 IPC),2014,30,2,32
A & N Islands,Acid attack (Section 326A IPC),2014,0,0,0
A & N Islands,Attempt to Acid Attack (Section 326B IPC),2014,0,0,0
A & N Islands,Dowry Deaths (Section 304-B IPC),2014,4,4,8
A & N Islands,Assault on women with intent to outrage her Modesty (Section 354 IPC),2014,46,1,47
A & N Islands,Sexual Harassment (Section 354A IPC),2014,20,1,21
A & N Islands,Assault on women with intent to Disrobe (Section 354B IPC),2014,1,0,1
A & N Islands,Voyeurism (Section 354C IPC),2014,1,0,1
A & N Islands,Stalking (Section 354D IPC),2014,7,0,7
A & N Islands,Others,2014,17,0,17
A & N Islands,Insult to the Modesty of Women (Section 509 IPC),2014,6,0,6
A & N Islands,At Office premises,2014,0,0,0
A & N Islands,Places related to work other than Office,2014,0,0,0
A & N Islands,In Public Transport system,2014,0,0,0
A & N Islands,In Other Places,2014,6,0,6
A & N Islands,Cruelty by Husband or his Relatives (Section 498-A IPC),2014,7,1,8
A & N Islands,Importation of Girls from Foreign Country (Section 366-B IPC),2014,0,0,0
A & N Islands,Causing Death by Negligence (Section 304-A IPC),2014,32,0,32
A & N Islands,Deaths due to negligent driving/act,2014,23,0,23
A & N Islands,Deaths due to Other Causes,2014,9,0,9
A & N Islands,"Offences against State (Section 121, 121A, 122, 123, 124-A IPC)",2014,0,0,0
A & N Islands,Sedition (Section 124A IPC),2014,0,0,0
A & N Islands,Other offences against State,2014,0,0,0
A & N Islands,Offences promoting enmity between different groups (Section 153A & 153B IPC),2014,1,0,1
A & N Islands,Promoting enmity on ground of religion race and place of Birth (Section 153A IPC),2014,1,0,1
A & N Islands,Imputation & assertions prejudicial to national integration (Section 153B IPC),2014,0,0,0
A & N Islands,Extortion (Section 384 - 389 IPC),2014,0,0,0
A & N Islands,Disclosure of Identity of Victims (Section 228 A IPC),2014,0,0,0
A & N Islands,Incidence of Rash Driving (Section 279 IPC Read with 337 & 338),2014,204,1,205
A & N Islands,Human Trafficking (Section 370 & 370A IPC),2014,0,0,0
A & N Islands,Unnatural Offences U/s 377 IPC,2014,3,0,3
A & N Islands,Other IPC crimes,2014,156,42,198
A & N Islands,Total Cognizable IPC crimes,2014,776,75,851
Chandigarh,Murder (Section 302 IPC),2014,41,5,46
Chandigarh,Attempt to commit Murder (Section 307 IPC),2014,73,0,73
Chandigarh,Culpable Homicide not amounting to Murder (Section 304 IPC),2014,11,0,11
Chandigarh,Attempt to commit Culpable Homicide (Section 308 IPC),2014,23,1,24
Chandigarh,Rape (Section 376 IPC),2014,63,3,66
Chandigarh,Custodial Rape,2014,0,0,0
Chandigarh,Gang Rape,2014,0,0,0
Chandigarh,Other Rape,2014,0,0,0
Chandigarh,Rape other than Custodial,2014,63,3,66
Chandigarh,Other Rape,2014,63,3,66
Chandigarh,Attempt to commit Rape (Section 376/511 IPC),2014,6,0,6
Chandigarh,"Kidnapping & Abduction_Total (Section 3,364,364A, 366-369 IPC)",2014,64,4,68
Chandigarh,Kidnapping & Abduction (Section 363 IPC),2014,15,1,16
Chandigarh,Kidnaping & Abduction in order to Murder (Section 364 IPC),2014,0,0,0
Chandigarh,Kidnapping for Ransom (Section 364A IPC),2014,4,0,4
Chandigarh,Kidnapping & Abduction of Women to compel her for marriage (Section 366 IPC),2014,36,1,37
Chandigarh,Other Kidnapping,2014,9,2,11
Chandigarh,"Dacoity (Section 395,396-398 IPC)",2014,21,0,21
Chandigarh,Dacoity with Murder (Section 396 IPC),2014,0,0,0
Chandigarh,Other Dacoity,2014,21,0,21
Chandigarh,Making Preparation and Assembly for committing Dacoity (Section 399 & 402 IPC),2014,19,0,19
Chandigarh,"Robbery (Section 392 to 394, 397 and 398 IPC)",2014,148,0,148
Chandigarh,Criminal Trespass/Burglary_Total (Section 453 to 460 IPC),2014,148,6,154
Chandigarh,"Criminal Trespass/Burglary (Section 455, 457 & 458 IPC)",2014,78,4,82
Chandigarh,"House Trespass & House Breaking (Section 453,454,456,459 & 460 IPC)",2014,70,2,72
Chandigarh,Theft (Section 379 to 382 IPC),2014,637,32,669
Chandigarh,Auto Theft,2014,304,0,304
Chandigarh,Other Thefts,2014,333,32,365
Chandigarh,"Unlawful Assembly (Section 143,144 & 145)",2014,0,0,0
Chandigarh,"Riots (Section 147, 148, 149, 150 & 151 IPC)",2014,90,6,96
Chandigarh,Communal,2014,0,0,0
Chandigarh,Industrial,2014,0,0,0
Chandigarh,Political,2014,0,0,0
Chandigarh,Caste Conflict,2014,0,0,0
Chandigarh,SC/STs Vs. Non-SCs/STs,2014,0,0,0
Chandigarh,Other Caste Riots,2014,0,0,0
Chandigarh,Agrarian,2014,0,0,0
Chandigarh,Students,2014,18,0,18
Chandigarh,Sectarian,2014,0,0,0
Chandigarh,Other Riots,2014,72,6,78
Chandigarh,Criminal Breach of Trust (Section 406 to 409 IPC),2014,28,0,28
Chandigarh,Cheating (Section 420 IPC),2014,209,6,215
Chandigarh,"Forgery (Section 465, 468 & 471 IPC)",2014,1,0,1
Chandigarh,"Counterfeiting (Section 231-235,237-240, 242-243, 255 and 489-A to 489-E IPC)",2014,0,0,0
Chandigarh,"Offences related to Counterfeit Coin (Section 231-235,237, 238-240 & 242-243 IPC)",2014,0,0,0
Chandigarh,Counterfeiting Government Stamp (Section 255 IPC),2014,0,0,0
Chandigarh,Counterfeit currency & Bank notes (Section 489-A to 489-E IPC),2014,0,0,0
Chandigarh,Counterfeiting currency notes or Bank notes (Section 489A IPC),2014,0,0,0
Chandigarh,Using forged or counterfeit currency/Bank notes (Section 489B IPC),2014,0,0,0
Chandigarh,Possession of forged or counterfeiting currency / Bank notes (Section 489C IPC),2014,0,0,0
Chandigarh,Make/Possess materials for forging or counterfeiting currency/Bank notes (Section 489D IPC),2014,0,0,0
Chandigarh,Make/Use documents resembling currency notes/Bank notes (Section 489 E IPC),2014,0,0,0
Chandigarh,Arson (Section 435-436 & 438 IPC),2014,14,1,15
Chandigarh,"Grievous Hurt (Section 325,326,326A & 326 B IPC)",2014,44,1,45
Chandigarh,Grievous Hurt (Section 325 & 326 IPC),2014,44,1,45
Chandigarh,Acid attack (Section 326A IPC),2014,0,0,0
Chandigarh,Attempt to Acid Attack (Section 326B IPC),2014,0,0,0
Chandigarh,Dowry Deaths (Section 304-B IPC),2014,3,0,3
Chandigarh,Assault on women with intent to outrage her Modesty (Section 354 IPC),2014,119,0,119
Chandigarh,Sexual Harassment (Section 354A IPC),2014,39,0,39
Chandigarh,Assault on women with intent to Disrobe (Section 354B IPC),2014,4,0,4
Chandigarh,Voyeurism (Section 354C IPC),2014,3,0,3
Chandigarh,Stalking (Section 354D IPC),2014,12,0,12
Chandigarh,Others,2014,61,0,61
Chandigarh,Insult to the Modesty of Women (Section 509 IPC),2014,5,0,5
Chandigarh,At Office premises,2014,0,0,0
Chandigarh,Places related to work other than Office,2014,2,0,2
Chandigarh,In Public Transport system,2014,0,0,0
Chandigarh,In Other Places,2014,3,0,3
Chandigarh,Cruelty by Husband or his Relatives (Section 498-A IPC),2014,121,9,130
Chandigarh,Importation of Girls from Foreign Country (Section 366-B IPC),2014,0,0,0
Chandigarh,Causing Death by Negligence (Section 304-A IPC),2014,66,1,67
Chandigarh,Deaths due to negligent driving/act,2014,61,1,62
Chandigarh,Deaths due to Other Causes,2014,5,0,5
Chandigarh,"Offences against State (Section 121, 121A, 122, 123, 124-A IPC)",2014,0,0,0
Chandigarh,Sedition (Section 124A IPC),2014,0,0,0
Chandigarh,Other offences against State,2014,0,0,0
Chandigarh,Offences promoting enmity between different groups (Section 153A & 153B IPC),2014,0,0,0
Chandigarh,Promoting enmity on ground of religion race and place of Birth (Section 153A IPC),2014,0,0,0
Chandigarh,Imputation & assertions prejudicial to national integration (Section 153B IPC),2014,0,0,0
Chandigarh,Extortion (Section 384 - 389 IPC),2014,8,1,9
Chandigarh,Disclosure of Identity of Victims (Section 228 A IPC),2014,0,0,0
Chandigarh,Incidence of Rash Driving (Section 279 IPC Read with 337 & 338),2014,216,11,227
Chandigarh,Human Trafficking (Section 370 & 370A IPC),2014,0,0,0
Chandigarh,Unnatural Offences U/s 377 IPC,2014,5,0,5
Chandigarh,Other IPC crimes,2014,616,27,643
Chandigarh,Total Cognizable IPC crimes,2014,2799,114,2913
D&N Haveli,Murder (Section 302 IPC),2014,3,0,3
D&N Haveli,Attempt to commit Murder (Section 307 IPC),2014,10,1,11
D&N Haveli,Culpable Homicide not amounting to Murder (Section 304 IPC),2014,4,0,4
D&N Haveli,Attempt to commit Culpable Homicide (Section 308 IPC),2014,0,0,0
D&N Haveli,Rape (Section 376 IPC),2014,5,1,6
D&N Haveli,Custodial Rape,2014,0,0,0
D&N Haveli,Gang Rape,2014,0,0,0
D&N Haveli,Other Rape,2014,0,0,0
D&N Haveli,Rape other than Custodial,2014,5,1,6
D&N Haveli,Other Rape,2014,5,1,6
D&N Haveli,Attempt to commit Rape (Section 376/511 IPC),2014,0,0,0
D&N Haveli,"Kidnapping & Abduction_Total (Section 3,364,364A, 366-369 IPC)",2014,22,0,22
D&N Haveli,Kidnapping & Abduction (Section 363 IPC),2014,22,0,22
D&N Haveli,Kidnaping & Abduction in order to Murder (Section 364 IPC),2014,0,0,0
D&N Haveli,Kidnapping for Ransom (Section 364A IPC),2014,0,0,0
D&N Haveli,Kidnapping & Abduction of Women to compel her for marriage (Section 366 IPC),2014,0,0,0
D&N Haveli,Other Kidnapping,2014,0,0,0
D&N Haveli,"Dacoity (Section 395,396-398 IPC)",2014,4,0,4
D&N Haveli,Dacoity with Murder (Section 396 IPC),2014,0,0,0
D&N Haveli,Other Dacoity,2014,4,0,4
D&N Haveli,Making Preparation and Assembly for committing Dacoity (Section 399 & 402 IPC),2014,0,0,0
D&N Haveli,"Robbery (Section 392 to 394, 397 and 398 IPC)",2014,6,0,6
D&N Haveli,Criminal Trespass/Burglary_Total (Section 453 to 460 IPC),2014,26,0,26
D&N Haveli,"Criminal Trespass/Burglary (Section 455, 457 & 458 IPC)",2014,6,0,6
D&N Haveli,"House Trespass & House Breaking (Section 453,454,456,459 & 460 IPC)",2014,20,0,20
D&N Haveli,Theft (Section 379 to 382 IPC),2014,63,0,63
D&N Haveli,Auto Theft,2014,7,0,7
D&N Haveli,Other Thefts,2014,56,0,56
D&N Haveli,"Unlawful Assembly (Section 143,144 & 145)",2014,0,0,0
D&N Haveli,"Riots (Section 147, 148, 149, 150 & 151 IPC)",2014,49,2,51
D&N Haveli,Communal,2014,0,0,0
D&N Haveli,Industrial,2014,0,0,0
D&N Haveli,Political,2014,0,0,0
D&N Haveli,Caste Conflict,2014,0,0,0
D&N Haveli,SC/STs Vs. Non-SCs/STs,2014,0,0,0
D&N Haveli,Other Caste Riots,2014,0,0,0
D&N Haveli,Agrarian,2014,0,0,0
D&N Haveli,Students,2014,0,0,0
D&N Haveli,Sectarian,2014,0,0,0
D&N Haveli,Other Riots,2014,49,2,51
D&N Haveli,Criminal Breach of Trust (Section 406 to 409 IPC),2014,2,0,2
D&N Haveli,Cheating (Section 420 IPC),2014,22,1,23
D&N Haveli,"Forgery (Section 465, 468 & 471 IPC)",2014,0,0,0
D&N Haveli,"Counterfeiting (Section 231-235,237-240, 242-243, 255 and 489-A to 489-E IPC)",2014,2,0,2
D&N Haveli,"Offences related to Counterfeit Coin (Section 231-235,237, 238-240 & 242-243 IPC)",2014,0,0,0
D&N Haveli,Counterfeiting Government Stamp (Section 255 IPC),2014,0,0,0
D&N Haveli,Counterfeit currency & Bank notes (Section 489-A to 489-E IPC),2014,2,0,2
D&N Haveli,Counterfeiting currency notes or Bank notes (Section 489A IPC),2014,0,0,0
D&N Haveli,Using forged or counterfeit currency/Bank notes (Section 489B IPC),2014,2,0,2
D&N Haveli,Possession of forged or counterfeiting currency / Bank notes (Section 489C IPC),2014,0,0,0
D&N Haveli,Make/Possess materials for forging or counterfeiting currency/Bank notes (Section 489D IPC),2014,0,0,0
D&N Haveli,Make/Use documents resembling currency notes/Bank notes (Section 489 E IPC),2014,0,0,0
D&N Haveli,Arson (Section 435-436 & 438 IPC),2014,0,0,0
D&N Haveli,"Grievous Hurt (Section 325,326,326A & 326 B IPC)",2014,27,4,31
D&N Haveli,Grievous Hurt (Section 325 & 326 IPC),2014,27,4,31
D&N Haveli,Acid attack (Section 326A IPC),2014,0,0,0
D&N Haveli,Attempt to Acid Attack (Section 326B IPC),2014,0,0,0
D&N Haveli,Dowry Deaths (Section 304-B IPC),2014,0,0,0
D&N Haveli,Assault on women with intent to outrage her Modesty (Section 354 IPC),2014,2,0,2
D&N Haveli,Sexual Harassment (Section 354A IPC),2014,0,0,0
D&N Haveli,Assault on women with intent to Disrobe (Section 354B IPC),2014,0,0,0
D&N Haveli,Voyeurism (Section 354C IPC),2014,0,0,0
D&N Haveli,Stalking (Section 354D IPC),2014,0,0,0
D&N Haveli,Others,2014,2,0,2
D&N Haveli,Insult to the Modesty of Women (Section 509 IPC),2014,1,0,1
D&N Haveli,At Office premises,2014,0,0,0
D&N Haveli,Places related to work other than Office,2014,0,0,0
D&N Haveli,In Public Transport system,2014,0,0,0
D&N Haveli,In Other Places,2014,1,0,1
D&N Haveli,Cruelty by Husband or his Relatives (Section 498-A IPC),2014,4,1,5
D&N Haveli,Importation of Girls from Foreign Country (Section 366-B IPC),2014,0,0,0
D&N Haveli,Causing Death by Negligence (Section 304-A IPC),2014,60,0,60
D&N Haveli,Deaths due to negligent driving/act,2014,45,0,45
D&N Haveli,Deaths due to Other Causes,2014,15,0,15
D&N Haveli,"Offences against State (Section 121, 121A, 122, 123, 124-A IPC)",2014,0,0,0
D&N Haveli,Sedition (Section 124A IPC),2014,0,0,0
D&N Haveli,Other offences against State,2014,0,0,0
D&N Haveli,Offences promoting enmity between different groups (Section 153A & 153B IPC),2014,0,0,0
D&N Haveli,Promoting enmity on ground of religion race and place of Birth (Section 153A IPC),2014,0,0,0
D&N Haveli,Imputation & assertions prejudicial to national integration (Section 153B IPC),2014,0,0,0
D&N Haveli,Extortion (Section 384 - 389 IPC),2014,15,2,17
D&N Haveli,Disclosure of Identity of Victims (Section 228 A IPC),2014,0,0,0
D&N Haveli,Incidence of Rash Driving (Section 279 IPC Read with 337 & 338),2014,33,0,33
D&N Haveli,Human Trafficking (Section 370 & 370A IPC),2014,0,0,0
D&N Haveli,Unnatural Offences U/s 377 IPC,2014,0,0,0
D&N Haveli,Other IPC crimes,2014,33,1,34
D&N Haveli,Total Cognizable IPC crimes,2014,393,13,406
Daman & Diu,Murder (Section 302 IPC),2014,20,0,20
Daman & Diu,Attempt to commit Murder (Section 307 IPC),2014,11,0,11
Daman & Diu,Culpable Homicide not amounting to Murder (Section 304 IPC),2014,0,0,0
Daman & Diu,Attempt to commit Culpable Homicide (Section 308 IPC),2014,0,0,0
Daman & Diu,Rape (Section 376 IPC),2014,2,0,2
Daman & Diu,Custodial Rape,2014,0,0,0
Daman & Diu,Gang Rape,2014,0,0,0
Daman & Diu,Other Rape,2014,0,0,0
Daman & Diu,Rape other than Custodial,2014,2,0,2
Daman & Diu,Other Rape,2014,2,0,2
Daman & Diu,Attempt to commit Rape (Section 376/511 IPC),2014,0,0,0
Daman & Diu,"Kidnapping & Abduction_Total (Section 3,364,364A, 366-369 IPC)",2014,10,0,10
Daman & Diu,Kidnapping & Abduction (Section 363 IPC),2014,2,0,2
Daman & Diu,Kidnaping & Abduction in order to Murder (Section 364 IPC),2014,0,0,0
Daman & Diu,Kidnapping for Ransom (Section 364A IPC),2014,0,0,0
Daman & Diu,Kidnapping & Abduction of Women to compel her for marriage (Section 366 IPC),2014,0,0,0
Daman & Diu,Other Kidnapping,2014,8,0,8
Daman & Diu,"Dacoity (Section 395,396-398 IPC)",2014,1,0,1
Daman & Diu,Dacoity with Murder (Section 396 IPC),2014,0,0,0
Daman & Diu,Other Dacoity,2014,1,0,1
Daman & Diu,Making Preparation and Assembly for committing Dacoity (Section 399 & 402 IPC),2014,1,0,1
Daman & Diu,"Robbery (Section 392 to 394, 397 and 398 IPC)",2014,10,0,10
Daman & Diu,Criminal Trespass/Burglary_Total (Section 453 to 460 IPC),2014,26,0,26
Daman & Diu,"Criminal Trespass/Burglary (Section 455, 457 & 458 IPC)",2014,11,0,11
Daman & Diu,"House Trespass & House Breaking (Section 453,454,456,459 & 460 IPC)",2014,15,0,15
Daman & Diu,Theft (Section 379 to 382 IPC),2014,11,0,11
Daman & Diu,Auto Theft,2014,7,0,7
Daman & Diu,Other Thefts,2014,4,0,4
Daman & Diu,"Unlawful Assembly (Section 143,144 & 145)",2014,0,0,0
Daman & Diu,"Riots (Section 147, 148, 149, 150 & 151 IPC)",2014,36,1,37
Daman & Diu,Communal,2014,0,0,0
Daman & Diu,Industrial,2014,0,0,0
Daman & Diu,Political,2014,0,0,0
Daman & Diu,Caste Conflict,2014,0,0,0
Daman & Diu,SC/STs Vs. Non-SCs/STs,2014,0,0,0
Daman & Diu,Other Caste Riots,2014,0,0,0
Daman & Diu,Agrarian,2014,0,0,0
Daman & Diu,Students,2014,0,0,0
Daman & Diu,Sectarian,2014,0,0,0
Daman & Diu,Other Riots,2014,36,1,37
Daman & Diu,Criminal Breach of Trust (Section 406 to 409 IPC),2014,0,0,0
Daman & Diu,Cheating (Section 420 IPC),2014,71,0,71
Daman & Diu,"Forgery (Section 465, 468 & 471 IPC)",2014,11,0,11
Daman & Diu,"Counterfeiting (Section 231-235,237-240, 242-243, 255 and 489-A to 489-E IPC)",2014,0,0,0
Daman & Diu,"Offences related to Counterfeit Coin (Section 231-235,237, 238-240 & 242-243 IPC)",2014,0,0,0
Daman & Diu,Counterfeiting Government Stamp (Section 255 IPC),2014,0,0,0
Daman & Diu,Counterfeit currency & Bank notes (Section 489-A to 489-E IPC),2014,0,0,0
Daman & Diu,Counterfeiting currency notes or Bank notes (Section 489A IPC),2014,0,0,0
Daman & Diu,Using forged or counterfeit currency/Bank notes (Section 489B IPC),2014,0,0,0
Daman & Diu,Possession of forged or counterfeiting currency / Bank notes (Section 489C IPC),2014,0,0,0
Daman & Diu,Make/Possess materials for forging or counterfeiting currency/Bank notes (Section 489D IPC),2014,0,0,0
Daman & Diu,Make/Use documents resembling currency notes/Bank notes (Section 489 E IPC),2014,0,0,0
Daman & Diu,Arson (Section 435-436 & 438 IPC),2014,2,0,2
Daman & Diu,"Grievous Hurt (Section 325,326,326A & 326 B IPC)",2014,21,2,23
Daman & Diu,Grievous Hurt (Section 325 & 326 IPC),2014,21,2,23
Daman & Diu,Acid attack (Section 326A IPC),2014,0,0,0
Daman & Diu,Attempt to Acid Attack (Section 326B IPC),2014,0,0,0
Daman & Diu,Dowry Deaths (Section 304-B IPC),2014,0,0,0
Daman & Diu,Assault on women with intent to outrage her Modesty (Section 354 IPC),2014,3,0,3
Daman & Diu,Sexual Harassment (Section 354A IPC),2014,3,0,3
Daman & Diu,Assault on women with intent to Disrobe (Section 354B IPC),2014,0,0,0
Daman & Diu,Voyeurism (Section 354C IPC),2014,0,0,0
Daman & Diu,Stalking (Section 354D IPC),2014,0,0,0
Daman & Diu,Others,2014,0,0,0
Daman & Diu,Insult to the Modesty of Women (Section 509 IPC),2014,0,0,0
Daman & Diu,At Office premises,2014,0,0,0
Daman & Diu,Places related to work other than Office,2014,0,0,0
Daman & Diu,In Public Transport system,2014,0,0,0
Daman & Diu,In Other Places,2014,0,0,0
Daman & Diu,Cruelty by Husband or his Relatives (Section 498-A IPC),2014,0,0,0
Daman & Diu,Importation of Girls from Foreign Country (Section 366-B IPC),2014,0,0,0
Daman & Diu,Causing Death by Negligence (Section 304-A IPC),2014,17,0,17
Daman & Diu,Deaths due to negligent driving/act,2014,10,0,10
Daman & Diu,Deaths due to Other Causes,2014,7,0,7
Daman & Diu,"Offences against State (Section 121, 121A, 122, 123, 124-A IPC)",2014,0,0,0
Daman & Diu,Sedition (Section 124A IPC),2014,0,0,0
Daman & Diu,Other offences against State,2014,0,0,0
Daman & Diu,Offences promoting enmity between different groups (Section 153A & 153B IPC),2014,0,0,0
Daman & Diu,Promoting enmity on ground of religion race and place of Birth (Section 153A IPC),2014,0,0,0
Daman & Diu,Imputation & assertions prejudicial to national integration (Section 153B IPC),2014,0,0,0
Daman & Diu,Extortion (Section 384 - 389 IPC),2014,4,0,4
Daman & Diu,Disclosure of Identity of Victims (Section 228 A IPC),2014,0,0,0
Daman & Diu,Incidence of Rash Driving (Section 279 IPC Read with 337 & 338),2014,26,0,26
Daman & Diu,Human Trafficking (Section 370 & 370A IPC),2014,0,0,0
Daman & Diu,Unnatural Offences U/s 377 IPC,2014,0,0,0
Daman & Diu,Other IPC crimes,2014,51,6,57
Daman & Diu,Total Cognizable IPC crimes,2014,334,9,343
Delhi UT,Murder (Section 302 IPC),2014,949,29,978
Delhi UT,Attempt to commit Murder (Section 307 IPC),2014,1327,15,1342
Delhi UT,Culpable Homicide not amounting to Murder (Section 304 IPC),2014,75,1,76
Delhi UT,Attempt to commit Culpable Homicide (Section 308 IPC),2014,1332,28,1360
Delhi UT,Rape (Section 376 IPC),2014,2040,65,2105
Delhi UT,Custodial Rape,2014,0,0,0
Delhi UT,Gang Rape,2014,0,0,0
Delhi UT,Other Rape,2014,0,0,0
Delhi UT,Rape other than Custodial,2014,2040,65,2105
Delhi UT,Gang Rape,2014,203,10,213
Delhi UT,Other Rape,2014,1837,55,1892
Delhi UT,Attempt to commit Rape (Section 376/511 IPC),2014,62,0,62
Delhi UT,"Kidnapping & Abduction_Total (Section 3,364,364A, 366-369 IPC)",2014,734,21,755
Delhi UT,Kidnapping & Abduction (Section 363 IPC),2014,584,15,599
Delhi UT,Kidnaping & Abduction in order to Murder (Section 364 IPC),2014,0,0,0
Delhi UT,Kidnapping for Ransom (Section 364A IPC),2014,65,2,67
Delhi UT,Kidnapping & Abduction of Women to compel her for marriage (Section 366 IPC),2014,1,0,1
Delhi UT,Other Kidnapping,2014,84,4,88
Delhi UT,"Dacoity (Section 395,396-398 IPC)",2014,287,0,287
Delhi UT,Dacoity with Murder (Section 396 IPC),2014,5,0,5
Delhi UT,Other Dacoity,2014,282,0,282
Delhi UT,Making Preparation and Assembly for committing Dacoity (Section 399 & 402 IPC),2014,15,0,15
Delhi UT,"Robbery (Section 392 to 394, 397 and 398 IPC)",2014,5195,24,5219
Delhi UT,Criminal Trespass/Burglary_Total (Section 453 to 460 IPC),2014,2701,9,2710
Delhi UT,"Criminal Trespass/Burglary (Section 455, 457 & 458 IPC)",2014,1574,3,1577
Delhi UT,"House Trespass & House Breaking (Section 453,454,456,459 & 460 IPC)",2014,1127,6,1133
Delhi UT,Theft (Section 379 to 382 IPC),2014,13535,158,13693
Delhi UT,Auto Theft,2014,3545,0,3545
Delhi UT,Other Thefts,2014,9990,158,10148
Delhi UT,"Unlawful Assembly (Section 143,144 & 145)",2014,0,0,0
Delhi UT,"Riots (Section 147, 148, 149, 150 & 151 IPC)",2014,516,25,541
Delhi UT,Communal,2014,0,0,0
Delhi UT,Industrial,2014,0,0,0
Delhi UT,Political,2014,0,0,0
Delhi UT,Caste Conflict,2014,13,0,13
Delhi UT,SC/STs Vs. Non-SCs/STs,2014,0,0,0
Delhi UT,Other Caste Riots,2014,13,0,13
Delhi UT,Agrarian,2014,0,0,0
Delhi UT,Students,2014,15,0,15
Delhi UT,Sectarian,2014,0,0,0
Delhi UT,Other Riots,2014,488,25,513
Delhi UT,Criminal Breach of Trust (Section 406 to 409 IPC),2014,250,0,250
Delhi UT,Cheating (Section 420 IPC),2014,1326,33,1359
Delhi UT,"Forgery (Section 465, 468 & 471 IPC)",2014,342,29,371
Delhi UT,"Counterfeiting (Section 231-235,237-240, 242-243, 255 and 489-A to 489-E IPC)",2014,51,1,52
Delhi UT,"Offences related to Counterfeit Coin (Section 231-235,237, 238-240 & 242-243 IPC)",2014,1,0,1
Delhi UT,Counterfeiting Government Stamp (Section 255 IPC),2014,0,0,0
Delhi UT,Counterfeit currency & Bank notes (Section 489-A to 489-E IPC),2014,50,1,51
Delhi UT,Counterfeiting currency notes or Bank notes (Section 489A IPC),2014,12,0,12
Delhi UT,Using forged or counterfeit currency/Bank notes (Section 489B IPC),2014,5,0,5
Delhi UT,Possession of forged or counterfeiting currency / Bank notes (Section 489C IPC),2014,33,1,34
Delhi UT,Make/Possess materials for forging or counterfeiting currency/Bank notes (Section 489D IPC),2014,0,0,0
Delhi UT,Make/Use documents resembling currency notes/Bank notes (Section 489 E IPC),2014,0,0,0
Delhi UT,Arson (Section 435-436 & 438 IPC),2014,66,0,66
Delhi UT,"Grievous Hurt (Section 325,326,326A & 326 B IPC)",2014,793,25,818
Delhi UT,Grievous Hurt (Section 325 & 326 IPC),2014,762,24,786
Delhi UT,Acid attack (Section 326A IPC),2014,19,1,20
Delhi UT,Attempt to Acid Attack (Section 326B IPC),2014,12,0,12
Delhi UT,Dowry Deaths (Section 304-B IPC),2014,252,43,295
Delhi UT,Assault on women with intent to outrage her Modesty (Section 354 IPC),2014,3803,34,3837
Delhi UT,Sexual Harassment (Section 354A IPC),2014,1048,4,1052
Delhi UT,Assault on women with intent to Disrobe (Section 354B IPC),2014,334,4,338
Delhi UT,Voyeurism (Section 354C IPC),2014,27,0,27
Delhi UT,Stalking (Section 354D IPC),2014,421,0,421
Delhi UT,Others,2014,1973,26,1999
Delhi UT,Insult to the Modesty of Women (Section 509 IPC),2014,934,7,941
Delhi UT,At Office premises,2014,8,0,8
Delhi UT,Places related to work other than Office,2014,20,0,20
Delhi UT,In Public Transport system,2014,6,0,6
Delhi UT,In Other Places,2014,900,7,907
Delhi UT,Cruelty by Husband or his Relatives (Section 498-A IPC),2014,530,47,577
Delhi UT,Importation of Girls from Foreign Country (Section 366-B IPC),2014,0,0,0
Delhi UT,Causing Death by Negligence (Section 304-A IPC),2014,1209,6,1215
Delhi UT,Deaths due to negligent driving/act,2014,1049,6,1055
Delhi UT,Deaths due to Other Causes,2014,160,0,160
Delhi UT,"Offences against State (Section 121, 121A, 122, 123, 124-A IPC)",2014,0,0,0
Delhi UT,Sedition (Section 124A IPC),2014,0,0,0
Delhi UT,Other offences against State,2014,0,0,0
Delhi UT,Offences promoting enmity between different groups (Section 153A & 153B IPC),2014,36,0,36
Delhi UT,Promoting enmity on ground of religion race and place of Birth (Section 153A IPC),2014,36,0,36
Delhi UT,Imputation & assertions prejudicial to national integration (Section 153B IPC),2014,0,0,0
Delhi UT,Extortion (Section 384 - 389 IPC),2014,202,20,222
Delhi UT,Disclosure of Identity of Victims (Section 228 A IPC),2014,0,0,0
Delhi UT,Incidence of Rash Driving (Section 279 IPC Read with 337 & 338),2014,6124,97,6221
Delhi UT,Human Trafficking (Section 370 & 370A IPC),2014,7,0,7
Delhi UT,Unnatural Offences U/s 377 IPC,2014,247,0,247
Delhi UT,Other IPC crimes,2014,17596,533,18129
Delhi UT,Total Cognizable IPC crimes,2014,62536,1250,63786
Lakshadweep,Murder (Section 302 IPC),2014,0,0,0
Lakshadweep,Attempt to commit Murder (Section 307 IPC),2014,0,0,0
Lakshadweep,Culpable Homicide not amounting to Murder (Section 304 IPC),2014,0,0,0
Lakshadweep,Attempt to commit Culpable Homicide (Section 308 IPC),2014,0,0,0
Lakshadweep,Rape (Section 376 IPC),2014,1,0,1
Lakshadweep,Custodial Rape,2014,0,0,0
Lakshadweep,Gang Rape,2014,0,0,0
Lakshadweep,Other Rape,2014,0,0,0
Lakshadweep,Rape other than Custodial,2014,1,0,1
Lakshadweep,Other Rape,2014,1,0,1
Lakshadweep,Attempt to commit Rape (Section 376/511 IPC),2014,0,0,0
Lakshadweep,"Kidnapping & Abduction_Total (Section 3,364,364A, 366-369 IPC)",2014,0,0,0
Lakshadweep,Kidnapping & Abduction (Section 363 IPC),2014,0,0,0
Lakshadweep,Kidnaping & Abduction in order to Murder (Section 364 IPC),2014,0,0,0
Lakshadweep,Kidnapping for Ransom (Section 364A IPC),2014,0,0,0
Lakshadweep,Kidnapping & Abduction of Women to compel her for marriage (Section 366 IPC),2014,0,0,0
Lakshadweep,Other Kidnapping,2014,0,0,0
Lakshadweep,"Dacoity (Section 395,396-398 IPC)",2014,0,0,0
Lakshadweep,Dacoity with Murder (Section 396 IPC),2014,0,0,0
Lakshadweep,Other Dacoity,2014,0,0,0
Lakshadweep,Making Preparation and Assembly for committing Dacoity (Section 399 & 402 IPC),2014,0,0,0
Lakshadweep,"Robbery (Section 392 to 394, 397 and 398 IPC)",2014,0,0,0
Lakshadweep,Criminal Trespass/Burglary_Total (Section 453 to 460 IPC),2014,1,0,1
Lakshadweep,"Criminal Trespass/Burglary (Section 455, 457 & 458 IPC)",2014,0,0,0
Lakshadweep,"House Trespass & House Breaking (Section 453,454,456,459 & 460 IPC)",2014,1,0,1
Lakshadweep,Theft (Section 379 to 382 IPC),2014,12,0,12
Lakshadweep,Auto Theft,2014,0,0,0
Lakshadweep,Other Thefts,2014,12,0,12
Lakshadweep,"Unlawful Assembly (Section 143,144 & 145)",2014,11,0,11
Lakshadweep,"Riots (Section 147, 148, 149, 150 & 151 IPC)",2014,14,0,14
Lakshadweep,Communal,2014,0,0,0
Lakshadweep,Industrial,2014,0,0,0
Lakshadweep,Political,2014,14,0,14
Lakshadweep,Caste Conflict,2014,0,0,0
Lakshadweep,SC/STs Vs. Non-SCs/STs,2014,0,0,0
Lakshadweep,Other Caste Riots,2014,0,0,0
Lakshadweep,Agrarian,2014,0,0,0
Lakshadweep,Students,2014,0,0,0
Lakshadweep,Sectarian,2014,0,0,0
Lakshadweep,Other Riots,2014,0,0,0
Lakshadweep,Criminal Breach of Trust (Section 406 to 409 IPC),2014,0,0,0
Lakshadweep,Cheating (Section 420 IPC),2014,0,0,0
Lakshadweep,"Forgery (Section 465, 468 & 471 IPC)",2014,0,0,0
Lakshadweep,"Counterfeiting (Section 231-235,237-240, 242-243, 255 and 489-A to 489-E IPC)",2014,0,0,0
Lakshadweep,"Offences related to Counterfeit Coin (Section 231-235,237, 238-240 & 242-243 IPC)",2014,0,0,0
Lakshadweep,Counterfeiting Government Stamp (Section 255 IPC),2014,0,0,0
Lakshadweep,Counterfeit currency & Bank notes (Section 489-A to 489-E IPC),2014,0,0,0
Lakshadweep,Counterfeiting currency notes or Bank notes (Section 489A IPC),2014,0,0,0
Lakshadweep,Using forged or counterfeit currency/Bank notes (Section 489B IPC),2014,0,0,0
Lakshadweep,Possession of forged or counterfeiting currency / Bank notes (Section 489C IPC),2014,0,0,0
Lakshadweep,Make/Possess materials for forging or counterfeiting currency/Bank notes (Section 489D IPC),2014,0,0,0
Lakshadweep,Make/Use documents resembling currency notes/Bank notes (Section 489 E IPC),2014,0,0,0
Lakshadweep,Arson (Section 435-436 & 438 IPC),2014,0,0,0
Lakshadweep,"Grievous Hurt (Section 325,326,326A & 326 B IPC)",2014,0,0,0
Lakshadweep,Grievous Hurt (Section 325 & 326 IPC),2014,0,0,0
Lakshadweep,Acid attack (Section 326A IPC),2014,0,0,0
Lakshadweep,Attempt to Acid Attack (Section 326B IPC),2014,0,0,0
Lakshadweep,Dowry Deaths (Section 304-B IPC),2014,0,0,0
Lakshadweep,Assault on women with intent to outrage her Modesty (Section 354 IPC),2014,2,0,2
Lakshadweep,Sexual Harassment (Section 354A IPC),2014,0,0,0
Lakshadweep,Assault on women with intent to Disrobe (Section 354B IPC),2014,0,0,0
Lakshadweep,Voyeurism (Section 354C IPC),2014,0,0,0
Lakshadweep,Stalking (Section 354D IPC),2014,0,0,0
Lakshadweep,Others,2014,2,0,2
Lakshadweep,Insult to the Modesty of Women (Section 509 IPC),2014,0,0,0
Lakshadweep,At Office premises,2014,0,0,0
Lakshadweep,Places related to work other than Office,2014,0,0,0
Lakshadweep,In Public Transport system,2014,0,0,0
Lakshadweep,In Other Places,2014,0,0,0
Lakshadweep,Cruelty by Husband or his Relatives (Section 498-A IPC),2014,0,0,0
Lakshadweep,Importation of Girls from Foreign Country (Section 366-B IPC),2014,0,0,0
Lakshadweep,Causing Death by Negligence (Section 304-A IPC),2014,0,0,0
Lakshadweep,Deaths due to negligent driving/act,2014,0,0,0
Lakshadweep,Deaths due to Other Causes,2014,0,0,0
Lakshadweep,"Offences against State (Section 121, 121A, 122, 123, 124-A IPC)",2014,0,0,0
Lakshadweep,Sedition (Section 124A IPC),2014,0,0,0
Lakshadweep,Other offences against State,2014,0,0,0
Lakshadweep,Offences promoting enmity between different groups (Section 153A & 153B IPC),2014,0,0,0
Lakshadweep,Promoting enmity on ground of religion race and place of Birth (Section 153A IPC),2014,0,0,0
Lakshadweep,Imputation & assertions prejudicial to national integration (Section 153B IPC),2014,0,0,0
Lakshadweep,Extortion (Section 384 - 389 IPC),2014,0,0,0
Lakshadweep,Disclosure of Identity of Victims (Section 228 A IPC),2014,0,0,0
Lakshadweep,Incidence of Rash Driving (Section 279 IPC Read with 337 & 338),2014,0,0,0
Lakshadweep,Human Trafficking (Section 370 & 370A IPC),2014,0,0,0
Lakshadweep,Unnatural Offences U/s 377 IPC,2014,0,0,0
Lakshadweep,Other IPC crimes,2014,10,0,10
Lakshadweep,Total Cognizable IPC crimes,2014,51,0,51
Puducherry,Murder (Section 302 IPC),2014,147,5,152
Puducherry,Attempt to commit Murder (Section 307 IPC),2014,169,0,169
Puducherry,Culpable Homicide not amounting to Murder (Section 304 IPC),2014,9,0,9
Puducherry,Attempt to commit Culpable Homicide (Section 308 IPC),2014,0,0,0
Puducherry,Rape (Section 376 IPC),2014,15,0,15
Puducherry,Custodial Rape,2014,5,0,5
Puducherry,Gang Rape,2014,0,0,0
Puducherry,Other Rape,2014,5,0,5
Puducherry,Rape other than Custodial,2014,10,0,10
Puducherry,Other Rape,2014,10,0,10
Puducherry,Attempt to commit Rape (Section 376/511 IPC),2014,0,0,0
Puducherry,"Kidnapping & Abduction_Total (Section 3,364,364A, 366-369 IPC)",2014,17,0,17
Puducherry,Kidnapping & Abduction (Section 363 IPC),2014,8,0,8
Puducherry,Kidnaping & Abduction in order to Murder (Section 364 IPC),2014,0,0,0
Puducherry,Kidnapping for Ransom (Section 364A IPC),2014,6,0,6
Puducherry,Kidnapping & Abduction of Women to compel her for marriage (Section 366 IPC),2014,1,0,1
Puducherry,Other Kidnapping,2014,2,0,2
Puducherry,"Dacoity (Section 395,396-398 IPC)",2014,9,0,9
Puducherry,Dacoity with Murder (Section 396 IPC),2014,0,0,0
Puducherry,Other Dacoity,2014,9,0,9
Puducherry,Making Preparation and Assembly for committing Dacoity (Section 399 & 402 IPC),2014,37,0,37
Puducherry,"Robbery (Section 392 to 394, 397 and 398 IPC)",2014,7,0,7
Puducherry,Criminal Trespass/Burglary_Total (Section 453 to 460 IPC),2014,69,0,69
Puducherry,"Criminal Trespass/Burglary (Section 455, 457 & 458 IPC)",2014,50,0,50
Puducherry,"House Trespass & House Breaking (Section 453,454,456,459 & 460 IPC)",2014,19,0,19
Puducherry,Theft (Section 379 to 382 IPC),2014,224,10,234
Puducherry,Auto Theft,2014,109,0,109
Puducherry,Other Thefts,2014,115,10,125
Puducherry,"Unlawful Assembly (Section 143,144 & 145)",2014,57,0,57
Puducherry,"Riots (Section 147, 148, 149, 150 & 151 IPC)",2014,198,7,205
Puducherry,Communal,2014,102,4,106
Puducherry,Industrial,2014,0,0,0
Puducherry,Political,2014,23,0,23
Puducherry,Caste Conflict,2014,31,3,34
Puducherry,SC/STs Vs. Non-SCs/STs,2014,13,0,13
Puducherry,Other Caste Riots,2014,18,3,21
Puducherry,Agrarian,2014,0,0,0
Puducherry,Students,2014,11,0,11
Puducherry,Sectarian,2014,0,0,0
Puducherry,Other Riots,2014,31,0,31
Puducherry,Criminal Breach of Trust (Section 406 to 409 IPC),2014,9,2,11
Puducherry,Cheating (Section 420 IPC),2014,61,14,75
Puducherry,"Forgery (Section 465, 468 & 471 IPC)",2014,33,6,39
Puducherry,"Counterfeiting (Section 231-235,237-240, 242-243, 255 and 489-A to 489-E IPC)",2014,0,0,0
Puducherry,"Offences related to Counterfeit Coin (Section 231-235,237, 238-240 & 242-243 IPC)",2014,0,0,0
Puducherry,Counterfeiting Government Stamp (Section 255 IPC),2014,0,0,0
Puducherry,Counterfeit currency & Bank notes (Section 489-A to 489-E IPC),2014,0,0,0
Puducherry,Counterfeiting currency notes or Bank notes (Section 489A IPC),2014,0,0,0
Puducherry,Using forged or counterfeit currency/Bank notes (Section 489B IPC),2014,0,0,0
Puducherry,Possession of forged or counterfeiting currency / Bank notes (Section 489C IPC),2014,0,0,0
Puducherry,Make/Possess materials for forging or counterfeiting currency/Bank notes (Section 489D IPC),2014,0,0,0
Puducherry,Make/Use documents resembling currency notes/Bank notes (Section 489 E IPC),2014,0,0,0
Puducherry,Arson (Section 435-436 & 438 IPC),2014,0,0,0
Puducherry,"Grievous Hurt (Section 325,326,326A & 326 B IPC)",2014,135,3,138
Puducherry,Grievous Hurt (Section 325 & 326 IPC),2014,135,3,138
Puducherry,Acid attack (Section 326A IPC),2014,0,0,0
Puducherry,Attempt to Acid Attack (Section 326B IPC),2014,0,0,0
Puducherry,Dowry Deaths (Section 304-B IPC),2014,3,0,3
Puducherry,Assault on women with intent to outrage her Modesty (Section 354 IPC),2014,30,5,35
Puducherry,Sexual Harassment (Section 354A IPC),2014,5,2,7
Puducherry,Assault on women with intent to Disrobe (Section 354B IPC),2014,8,2,10
Puducherry,Voyeurism (Section 354C IPC),2014,2,0,2
Puducherry,Stalking (Section 354D IPC),2014,1,0,1
Puducherry,Others,2014,14,1,15
Puducherry,Insult to the Modesty of Women (Section 509 IPC),2014,17,0,17
Puducherry,At Office premises,2014,4,0,4
Puducherry,Places related to work other than Office,2014,2,0,2
Puducherry,In Public Transport system,2014,0,0,0
Puducherry,In Other Places,2014,11,0,11
Puducherry,Cruelty by Husband or his Relatives (Section 498-A IPC),2014,4,0,4
Puducherry,Importation of Girls from Foreign Country (Section 366-B IPC),2014,0,0,0
Puducherry,Causing Death by Negligence (Section 304-A IPC),2014,200,0,200
Puducherry,Deaths due to negligent driving/act,2014,187,0,187
Puducherry,Deaths due to Other Causes,2014,13,0,13
Puducherry,"Offences against State (Section 121, 121A, 122, 123, 124-A IPC)",2014,0,0,0
Puducherry,Sedition (Section 124A IPC),2014,0,0,0
Puducherry,Other offences against State,2014,0,0,0
Puducherry,Offences promoting enmity between different groups (Section 153A & 153B IPC),2014,2,0,2
Puducherry,Promoting enmity on ground of religion race and place of Birth (Section 153A IPC),2014,2,0,2
Puducherry,Imputation & assertions prejudicial to national integration (Section 153B IPC),2014,0,0,0
Puducherry,Extortion (Section 384 - 389 IPC),2014,12,1,13
Puducherry,Disclosure of Identity of Victims (Section 228 A IPC),2014,1,0,1
Puducherry,Incidence of Rash Driving (Section 279 IPC Read with 337 & 338),2014,1120,4,1124
Puducherry,Human Trafficking (Section 370 & 370A IPC),2014,0,0,0
Puducherry,Unnatural Offences U/s 377 IPC,2014,0,0,0
Puducherry,Other IPC crimes,2014,1547,136,1683
Puducherry,Total Cognizable IPC crimes,2014,4132,193,4325
Total (States),Murder (Section 302 IPC),2014,64091,4021,68112
Total (States),Attempt to commit Murder (Section 307 IPC),2014,80753,3776,84529
Total (States),Culpable Homicide not amounting to Murder (Section 304 IPC),2014,6784,243,7027
Total (States),Attempt to commit Culpable Homicide (Section 308 IPC),2014,5705,135,5840
Total (States),Rape (Section 376 IPC),2014,44948,1013,45961
Total (States),Custodial Rape,2014,281,0,281
Total (States),Gang Rape,2014,13,0,13
Total (States),Other Rape,2014,268,0,268
Total (States),Rape other than Custodial,2014,44667,1013,45680
Total (States),Gang Rape,2014,4710,45,4755
Total (States),Other Rape,2014,39957,968,40925
Total (States),Attempt to commit Rape (Section 376/511 IPC),2014,4365,32,4397
Total (States),"Kidnapping & Abduction_Total (Section 3,364,364A, 366-369 IPC)",2014,78745,2850,81595
Total (States),Kidnapping & Abduction (Section 363 IPC),2014,16341,792,17133
Total (States),Kidnaping & Abduction in order to Murder (Section 364 IPC),2014,2263,35,2298
Total (States),Kidnapping for Ransom (Section 364A IPC),2014,1427,27,1454
Total (States),Kidnapping & Abduction of Women to compel her for marriage (Section 366 IPC),2014,41375,1314,42689
Total (States),Other Kidnapping,2014,17339,682,18021
Total (States),"Dacoity (Section 395,396-398 IPC)",2014,17870,226,18096
Total (States),Dacoity with Murder (Section 396 IPC),2014,326,4,330
Total (States),Other Dacoity,2014,17544,222,17766
Total (States),Making Preparation and Assembly for committing Dacoity (Section 399 & 402 IPC),2014,12552,20,12572
Total (States),"Robbery (Section 392 to 394, 397 and 398 IPC)",2014,45447,469,45916
Total (States),Criminal Trespass/Burglary_Total (Section 453 to 460 IPC),2014,86333,1135,87468
Total (States),"Criminal Trespass/Burglary (Section 455, 457 & 458 IPC)",2014,62536,667,63203
Total (States),"House Trespass & House Breaking (Section 453,454,456,459 & 460 IPC)",2014,23797,468,24265
Total (States),Theft (Section 379 to 382 IPC),2014,239647,5070,244717
Total (States),Auto Theft,2014,75587,120,75707
Total (States),Other Thefts,2014,164060,4950,169010
Total (States),"Unlawful Assembly (Section 143,144 & 145)",2014,42897,3710,46607
Total (States),"Riots (Section 147, 148, 149, 150 & 151 IPC)",2014,291671,15859,307530
Total (States),Communal,2014,5533,66,5599
Total (States),Industrial,2014,663,25,688
Total (States),Political,2014,10018,263,10281
Total (States),Caste Conflict,2014,7526,396,7922
Total (States),SC/STs Vs. Non-SCs/STs,2014,1894,86,1980
Total (States),Other Caste Riots,2014,5632,310,5942
Total (States),Agrarian,2014,3392,148,3540
Total (States),Students,2014,1381,49,1430
Total (States),Sectarian,2014,71,0,71
Total (States),Other Riots,2014,263087,14912,277999
Total (States),Criminal Breach of Trust (Section 406 to 409 IPC),2014,26335,729,27064
Total (States),Cheating (Section 420 IPC),2014,114929,4093,119022
Total (States),"Forgery (Section 465, 468 & 471 IPC)",2014,8520,247,8767
Total (States),"Counterfeiting (Section 231-235,237-240, 242-243, 255 and 489-A to 489-E IPC)",2014,2447,55,2502
Total (States),"Offences related to Counterfeit Coin (Section 231-235,237, 238-240 & 242-243 IPC)",2014,317,0,317
Total (States),Counterfeiting Government Stamp (Section 255 IPC),2014,2,0,2
Total (States),Counterfeit currency & Bank notes (Section 489-A to 489-E IPC),2014,2128,55,2183
Total (States),Counterfeiting currency notes or Bank notes (Section 489A IPC),2014,1036,24,1060
Total (States),Using forged or counterfeit currency/Bank notes (Section 489B IPC),2014,801,25,826
Total (States),Possession of forged or counterfeiting currency / Bank notes (Section 489C IPC),2014,234,3,237
Total (States),Make/Possess materials for forging or counterfeiting currency/Bank notes (Section 489D IPC),2014,32,1,33
Total (States),Make/Use documents resembling currency notes/Bank notes (Section 489 E IPC),2014,25,2,27
Total (States),Arson (Section 435-436 & 438 IPC),2014,14190,238,14428
Total (States),"Grievous Hurt (Section 325,326,326A & 326 B IPC)",2014,178368,9461,187829
Total (States),Grievous Hurt (Section 325 & 326 IPC),2014,178116,9447,187563
Total (States),Acid attack (Section 326A IPC),2014,207,14,221
Total (States),Attempt to Acid Attack (Section 326B IPC),2014,45,0,45
Total (States),Dowry Deaths (Section 304-B IPC),2014,18458,4820,23278
Total (States),Assault on women with intent to outrage her Modesty (Section 354 IPC),2014,97585,2613,100198
Total (States),Sexual Harassment (Section 354A IPC),2014,26520,322,26842
Total (States),Assault on women with intent to Disrobe (Section 354B IPC),2014,7718,184,7902
Total (States),Voyeurism (Section 354C IPC),2014,948,4,952
Total (States),Stalking (Section 354D IPC),2014,4975,23,4998
Total (States),Others,2014,57424,2080,59504
Total (States),Insult to the Modesty of Women (Section 509 IPC),2014,9809,238,10047
Total (States),At Office premises,2014,43,0,43
Total (States),Places related to work other than Office,2014,619,2,621
Total (States),In Public Transport system,2014,132,1,133
Total (States),In Other Places,2014,9015,235,9250
Total (States),Cruelty by Husband or his Relatives (Section 498-A IPC),2014,180764,44160,224924
Total (States),Importation of Girls from Foreign Country (Section 366-B IPC),2014,39,3,42
Total (States),Causing Death by Negligence (Section 304-A IPC),2014,120068,352,120420
Total (States),Deaths due to negligent driving/act,2014,112442,294,112736
Total (States),Deaths due to Other Causes,2014,7626,58,7684
Total (States),"Offences against State (Section 121, 121A, 122, 123, 124-A IPC)",2014,220,4,224
Total (States),Sedition (Section 124A IPC),2014,55,3,58
Total (States),Other offences against State,2014,165,1,166
Total (States),Offences promoting enmity between different groups (Section 153A & 153B IPC),2014,606,3,609
Total (States),Promoting enmity on ground of religion race and place of Birth (Section 153A IPC),2014,595,3,598
Total (States),Imputation & assertions prejudicial to national integration (Section 153B IPC),2014,11,0,11
Total (States),Extortion (Section 384 - 389 IPC),2014,9345,162,9507
Total (States),Disclosure of Identity of Victims (Section 228 A IPC),2014,1,0,1
Total (States),Incidence of Rash Driving (Section 279 IPC Read with 337 & 338),2014,384926,1242,386168
Total (States),Human Trafficking (Section 370 & 370A IPC),2014,1152,176,1328
Total (States),Unnatural Offences U/s 377 IPC,2014,1010,14,1024
Total (States),Other IPC crimes,2014,1334344,86044,1420388
Total (States),Total Cognizable IPC crimes,2014,3524924,193213,3718137
Total (UTs),Murder (Section 302 IPC),2014,1168,40,1208
Total (UTs),Attempt to commit Murder (Section 307 IPC),2014,1608,16,1624
Total (UTs),Culpable Homicide not amounting to Murder (Section 304 IPC),2014,106,2,108
Total (UTs),Attempt to commit Culpable Homicide (Section 308 IPC),2014,1357,29,1386
Total (UTs),Rape (Section 376 IPC),2014,2160,72,2232
Total (UTs),Custodial Rape,2014,5,0,5
Total (UTs),Gang Rape,2014,0,0,0
Total (UTs),Other Rape,2014,5,0,5
Total (UTs),Rape other than Custodial,2014,2155,72,2227
Total (UTs),Gang Rape,2014,207,10,217
Total (UTs),Other Rape,2014,1948,62,2010
Total (UTs),Attempt to commit Rape (Section 376/511 IPC),2014,68,0,68
Total (UTs),"Kidnapping & Abduction_Total (Section 3,364,364A, 366-369 IPC)",2014,867,25,892
Total (UTs),Kidnapping & Abduction (Section 363 IPC),2014,641,16,657
Total (UTs),Kidnaping & Abduction in order to Murder (Section 364 IPC),2014,0,0,0
Total (UTs),Kidnapping for Ransom (Section 364A IPC),2014,75,2,77
Total (UTs),Kidnapping & Abduction of Women to compel her for marriage (Section 366 IPC),2014,38,1,39
Total (UTs),Other Kidnapping,2014,113,6,119
Total (UTs),"Dacoity (Section 395,396-398 IPC)",2014,322,0,322
Total (UTs),Dacoity with Murder (Section 396 IPC),2014,5,0,5
Total (UTs),Other Dacoity,2014,317,0,317
Total (UTs),Making Preparation and Assembly for committing Dacoity (Section 399 & 402 IPC),2014,72,0,72
Total (UTs),"Robbery (Section 392 to 394, 397 and 398 IPC)",2014,5372,24,5396
Total (UTs),Criminal Trespass/Burglary_Total (Section 453 to 460 IPC),2014,3017,18,3035
Total (UTs),"Criminal Trespass/Burglary (Section 455, 457 & 458 IPC)",2014,1748,9,1757
Total (UTs),"House Trespass & House Breaking (Section 453,454,456,459 & 460 IPC)",2014,1269,9,1278
Total (UTs),Theft (Section 379 to 382 IPC),2014,14521,203,14724
Total (UTs),Auto Theft,2014,3973,0,3973
Total (UTs),Other Thefts,2014,10548,203,10751
Total (UTs),"Unlawful Assembly (Section 143,144 & 145)",2014,76,0,76
Total (UTs),"Riots (Section 147, 148, 149, 150 & 151 IPC)",2014,966,48,1014
Total (UTs),Communal,2014,102,4,106
Total (UTs),Industrial,2014,0,0,0
Total (UTs),Political,2014,37,0,37
Total (UTs),Caste Conflict,2014,44,3,47
Total (UTs),SC/STs Vs. Non-SCs/STs,2014,13,0,13
Total (UTs),Other Caste Riots,2014,31,3,34
Total (UTs),Agrarian,2014,0,0,0
Total (UTs),Students,2014,44,0,44
Total (UTs),Sectarian,2014,0,0,0
Total (UTs),Other Riots,2014,739,41,780
Total (UTs),Criminal Breach of Trust (Section 406 to 409 IPC),2014,294,2,296
Total (UTs),Cheating (Section 420 IPC),2014,1709,57,1766
Total (UTs),"Forgery (Section 465, 468 & 471 IPC)",2014,391,38,429
Total (UTs),"Counterfeiting (Section 231-235,237-240, 242-243, 255 and 489-A to 489-E IPC)",2014,55,1,56
Total (UTs),"Offences related to Counterfeit Coin (Section 231-235,237, 238-240 & 242-243 IPC)",2014,1,0,1
Total (UTs),Counterfeiting Government Stamp (Section 255 IPC),2014,0,0,0
Total (UTs),Counterfeit currency & Bank notes (Section 489-A to 489-E IPC),2014,54,1,55
Total (UTs),Counterfeiting currency notes or Bank notes (Section 489A IPC),2014,12,0,12
Total (UTs),Using forged or counterfeit currency/Bank notes (Section 489B IPC),2014,9,0,9
Total (UTs),Possession of forged or counterfeiting currency / Bank notes (Section 489C IPC),2014,33,1,34
Total (UTs),Make/Possess materials for forging or counterfeiting currency/Bank notes (Section 489D IPC),2014,0,0,0
Total (UTs),Make/Use documents resembling currency notes/Bank notes (Section 489 E IPC),2014,0,0,0
Total (UTs),Arson (Section 435-436 & 438 IPC),2014,87,1,88
Total (UTs),"Grievous Hurt (Section 325,326,326A & 326 B IPC)",2014,1050,37,1087
Total (UTs),Grievous Hurt (Section 325 & 326 IPC),2014,1019,36,1055
Total (UTs),Acid attack (Section 326A IPC),2014,19,1,20
Total (UTs),Attempt to Acid Attack (Section 326B IPC),2014,12,0,12
Total (UTs),Dowry Deaths (Section 304-B IPC),2014,262,47,309
Total (UTs),Assault on women with intent to outrage her Modesty (Section 354 IPC),2014,4005,40,4045
Total (UTs),Sexual Harassment (Section 354A IPC),2014,1115,7,1122
Total (UTs),Assault on women with intent to Disrobe (Section 354B IPC),2014,347,6,353
Total (UTs),Voyeurism (Section 354C IPC),2014,33,0,33
Total (UTs),Stalking (Section 354D IPC),2014,441,0,441
Total (UTs),Others,2014,2069,27,2096
Total (UTs),Insult to the Modesty of Women (Section 509 IPC),2014,963,7,970
Total (UTs),At Office premises,2014,12,0,12
Total (UTs),Places related to work other than Office,2014,24,0,24
Total (UTs),In Public Transport system,2014,6,0,6
Total (UTs),In Other Places,2014,921,7,928
Total (UTs),Cruelty by Husband or his Relatives (Section 498-A IPC),2014,666,58,724
Total (UTs),Importation of Girls from Foreign Country (Section 366-B IPC),2014,0,0,0
Total (UTs),Causing Death by Negligence (Section 304-A IPC),2014,1584,7,1591
Total (UTs),Deaths due to negligent driving/act,2014,1375,7,1382
Total (UTs),Deaths due to Other Causes,2014,209,0,209
Total (UTs),"Offences against State (Section 121, 121A, 122, 123, 124-A IPC)",2014,0,0,0
Total (UTs),Sedition (Section 124A IPC),2014,0,0,0
Total (UTs),Other offences against State,2014,0,0,0
Total (UTs),Offences promoting enmity between different groups (Section 153A & 153B IPC),2014,39,0,39
Total (UTs),Promoting enmity on ground of religion race and place of Birth (Section 153A IPC),2014,39,0,39
Total (UTs),Imputation & assertions prejudicial to national integration (Section 153B IPC),2014,0,0,0
Total (UTs),Extortion (Section 384 - 389 IPC),2014,241,24,265
Total (UTs),Disclosure of Identity of Victims (Section 228 A IPC),2014,1,0,1
Total (UTs),Incidence of Rash Driving (Section 279 IPC Read with 337 & 338),2014,7723,113,7836
Total (UTs),Human Trafficking (Section 370 & 370A IPC),2014,7,0,7
Total (UTs),Unnatural Offences U/s 377 IPC,2014,255,0,255
Total (UTs),Other IPC crimes,2014,20009,745,20754
Total (UTs),Total Cognizable IPC crimes,2014,71021,1654,72675
Total (All India),Murder (Section 302 IPC),2014,65259,4061,69320
Total (All India),Attempt to commit Murder (Section 307 IPC),2014,82361,3792,86153
Total (All India),Culpable Homicide not amounting to Murder (Section 304 IPC),2014,6890,245,7135
Total (All India),Attempt to commit Culpable Homicide (Section 308 IPC),2014,7062,164,7226
Total (All India),Rape (Section 376 IPC),2014,47108,1085,48193
Total (All India),Custodial Rape,2014,286,0,286
Total (All India),Gang Rape,2014,13,0,13
Total (All India),Other Rape,2014,273,0,273
Total (All India),Rape other than Custodial,2014,46822,1085,47907
Total (All India),Gang Rape,2014,4917,55,4972
Total (All India),Other Rape,2014,41905,1030,42935
Total (All India),Attempt to commit Rape (Section 376/511 IPC),2014,4433,32,4465
Total (All India),"Kidnapping & Abduction_Total (Section 3,364,364A, 366-369 IPC)",2014,79612,2875,82487
Total (All India),Kidnapping & Abduction (Section 363 IPC),2014,16982,808,17790
Total (All India),Kidnaping & Abduction in order to Murder (Section 364 IPC),2014,2263,35,2298
Total (All India),Kidnapping for Ransom (Section 364A IPC),2014,1502,29,1531
Total (All India),Kidnapping & Abduction of Women to compel her for marriage (Section 366 IPC),2014,41413,1315,42728
Total (All India),Other Kidnapping,2014,17452,688,18140
Total (All India),"Dacoity (Section 395,396-398 IPC)",2014,18192,226,18418
Total (All India),Dacoity with Murder (Section 396 IPC),2014,331,4,335
Total (All India),Other Dacoity,2014,17861,222,18083
Total (All India),Making Preparation and Assembly for committing Dacoity (Section 399 & 402 IPC),2014,12624,20,12644
Total (All India),"Robbery (Section 392 to 394, 397 and 398 IPC)",2014,50819,493,51312
Total (All India),Criminal Trespass/Burglary_Total (Section 453 to 460 IPC),2014,89350,1153,90503
Total (All India),"Criminal Trespass/Burglary (Section 455, 457 & 458 IPC)",2014,64284,676,64960
Total (All India),"House Trespass & House Breaking (Section 453,454,456,459 & 460 IPC)",2014,25066,477,25543
Total (All India),Theft (Section 379 to 382 IPC),2014,254168,5273,259441
Total (All India),Auto Theft,2014,79560,120,79680
Total (All India),Other Thefts,2014,174608,5153,179761
Total (All India),"Unlawful Assembly (Section 143,144 & 145)",2014,42973,3710,46683
Total (All India),"Riots (Section 147, 148, 149, 150 & 151 IPC)",2014,292637,15907,308544
Total (All India),Communal,2014,5635,70,5705
Total (All India),Industrial,2014,663,25,688
Total (All India),Political,2014,10055,263,10318
Total (All India),Caste Conflict,2014,7570,399,7969
Total (All India),SC/STs Vs. Non-SCs/STs,2014,1907,86,1993
Total (All India),Other Caste Riots,2014,5663,313,5976
Total (All India),Agrarian,2014,3392,148,3540
Total (All India),Students,2014,1425,49,1474
Total (All India),Sectarian,2014,71,0,71
Total (All India),Other Riots,2014,263826,14953,278779
Total (All India),Criminal Breach of Trust (Section 406 to 409 IPC),2014,26629,731,27360
Total (All India),Cheating (Section 420 IPC),2014,116638,4150,120788
Total (All India),"Forgery (Section 465, 468 & 471 IPC)",2014,8911,285,9196
Total (All India),"Counterfeiting (Section 231-235,237-240, 242-243, 255 and 489-A to 489-E IPC)",2014,2502,56,2558
Total (All India),"Offences related to Counterfeit Coin (Section 231-235,237, 238-240 & 242-243 IPC)",2014,318,0,318
Total (All India),Counterfeiting Government Stamp (Section 255 IPC),2014,2,0,2
Total (All India),Counterfeit currency & Bank notes (Section 489-A to 489-E IPC),2014,2182,56,2238
Total (All India),Counterfeiting currency notes or Bank notes (Section 489A IPC),2014,1048,24,1072
Total (All India),Using forged or counterfeit currency/Bank notes (Section 489B IPC),2014,810,25,835
Total (All India),Possession of forged or counterfeiting currency / Bank notes (Section 489C IPC),2014,267,4,271
Total (All India),Make/Possess materials for forging or counterfeiting currency/Bank notes (Section 489D IPC),2014,32,1,33
Total (All India),Make/Use documents resembling currency notes/Bank notes (Section 489 E IPC),2014,25,2,27
Total (All India),Arson (Section 435-436 & 438 IPC),2014,14277,239,14516
Total (All India),"Grievous Hurt (Section 325,326,326A & 326 B IPC)",2014,179418,9498,188916
Total (All India),Grievous Hurt (Section 325 & 326 IPC),2014,179135,9483,188618
Total (All India),Acid attack (Section 326A IPC),2014,226,15,241
Total (All India),Attempt to Acid Attack (Section 326B IPC),2014,57,0,57
Total (All India),Dowry Deaths (Section 304-B IPC),2014,18720,4867,23587
Total (All India),Assault on women with intent to outrage her Modesty (Section 354 IPC),2014,101590,2653,104243
Total (All India),Sexual Harassment (Section 354A IPC),2014,27635,329,27964
Total (All India),Assault on women with intent to Disrobe (Section 354B IPC),2014,8065,190,8255
Total (All India),Voyeurism (Section 354C IPC),2014,981,4,985
Total (All India),Stalking (Section 354D IPC),2014,5416,23,5439
Total (All India),Others,2014,59493,2107,61600
Total (All India),Insult to the Modesty of Women (Section 509 IPC),2014,10772,245,11017
Total (All India),At Office premises,2014,55,0,55
Total (All India),Places related to work other than Office,2014,643,2,645
Total (All India),In Public Transport system,2014,138,1,139
Total (All India),In Other Places,2014,9936,242,10178
Total (All India),Cruelty by Husband or his Relatives (Section 498-A IPC),2014,181430,44218,225648
Total (All India),Importation of Girls from Foreign Country (Section 366-B IPC),2014,39,3,42
Total (All India),Causing Death by Negligence (Section 304-A IPC),2014,121652,359,122011
Total (All India),Deaths due to negligent driving/act,2014,113817,301,114118
Total (All India),Deaths due to Other Causes,2014,7835,58,7893
Total (All India),"Offences against State (Section 121, 121A, 122, 123, 124-A IPC)",2014,220,4,224
Total (All India),Sedition (Section 124A IPC),2014,55,3,58
Total (All India),Other offences against State,2014,165,1,166
Total (All India),Offences promoting enmity between different groups (Section 153A & 153B IPC),2014,645,3,648
Total (All India),Promoting enmity on ground of religion race and place of Birth (Section 153A IPC),2014,634,3,637
Total (All India),Imputation & assertions prejudicial to national integration (Section 153B IPC),2014,11,0,11
Total (All India),Extortion (Section 384 - 389 IPC),2014,9586,186,9772
Total (All India),Disclosure of Identity of Victims (Section 228 A IPC),2014,2,0,2
Total (All India),Incidence of Rash Driving (Section 279 IPC Read with 337 & 338),2014,392649,1355,394004
Total (All India),Human Trafficking (Section 370 & 370A IPC),2014,1159,176,1335
Total (All India),Unnatural Offences U/s 377 IPC,2014,1265,14,1279
Total (All India),Other IPC crimes,2014,1354353,86789,1441142
Total (All India),Total Cognizable IPC crimes,2014,3595945,194867,3790812
